Random,Schl,Season,G,W,L,W-L%,MP,FG,FGA,FG%,2P,2PA,2P%,3P,3PA,3P%,FT,FTA,FT%,PTS,SeasonStart,Year
1,Villanova,2017-18,40,36,4,0.9,8075,1220,2440,0.5,756,1282,0.59,464,1158,0.401,559,718,0.779,3463,2017,18
2,UNC,2016-17,40,33,7,0.825,8025,1226,2633,0.466,943,1835,0.514,283,798,0.355,642,916,0.701,3377,2016,17
3,UNC,2015-16,40,33,7,0.825,8000,1235,2560,0.482,1011,1875,0.539,224,685,0.327,617,826,0.747,3311,2015,16
4,Gonzaga,2018-19,37,33,4,0.892,7399,1177,2239,0.526,890,1449,0.614,287,790,0.363,602,791,0.761,3243,2018,19
5,UCLA,2016-17,36,31,5,0.861,7200,1210,2320,0.522,856,1448,0.591,354,872,0.406,459,622,0.738,3233,2016,17
6,Kentucky,2016-17,38,32,6,0.842,7625,1134,2396,0.473,867,1639,0.529,267,757,0.353,690,980,0.704,3225,2016,17
7,Gonzaga,2016-17,39,37,2,0.949,7800,1149,2280,0.504,863,1531,0.564,286,749,0.382,638,890,0.717,3222,2016,17
8,Auburn,2018-19,40,30,10,0.75,8075,1097,2439,0.45,643,1235,0.521,454,1204,0.377,540,760,0.711,3188,2018,19
9,Kansas,2017-18,39,31,8,0.795,7825,1165,2366,0.492,774,1392,0.556,391,974,0.401,453,640,0.708,3174,2017,18
10,Duke,2018-19,38,32,6,0.842,7624,1157,2418,0.478,879,1515,0.58,278,903,0.308,551,803,0.686,3143,2018,19
11,Duke,2017-18,37,29,8,0.784,7450,1125,2288,0.492,816,1457,0.56,309,831,0.372,562,791,0.71,3121,2017,18
12,Villanova,2015-16,40,35,5,0.875,8025,1086,2247,0.483,739,1288,0.574,347,959,0.362,599,766,0.782,3118,2015,16
13,Texas Southern,2018-19,38,24,14,0.632,7750,1083,2379,0.455,807,1527,0.528,276,852,0.324,660,988,0.668,3102,2018,19
14,Kentucky,2011-12,40,38,2,0.95,8000,1096,2248,0.488,871,1653,0.527,225,595,0.378,678,938,0.723,3095,2011,12
15,BYU,2015-16,37,26,11,0.703,7425,1096,2369,0.463,766,1506,0.509,330,863,0.382,571,827,0.69,3093,2015,16
16,UNC,2011-12,38,32,6,0.842,7625,1134,2473,0.459,940,1893,0.497,194,580,0.334,629,922,0.682,3091,2011,12
17,Duke,2014-15,39,35,4,0.897,7850,1099,2191,0.502,816,1459,0.559,283,732,0.387,610,873,0.699,3091,2014,15
18,Gonzaga,2017-18,37,32,5,0.865,7497,1125,2261,0.498,797,1370,0.582,328,891,0.368,513,725,0.708,3091,2017,18
19,Green Bay,2018-19,38,21,17,0.553,7675,1106,2413,0.458,803,1534,0.523,303,879,0.345,575,818,0.703,3090,2018,19
20,VMI,2013-14,35,22,13,0.629,7150,1088,2441,0.446,775,1479,0.524,313,962,0.325,600,842,0.713,3089,2013,14
21,Kansas,2015-16,38,33,5,0.868,7700,1092,2207,0.495,788,1479,0.533,304,728,0.418,601,843,0.713,3089,2015,16
22,UNC,2018-19,36,29,7,0.806,7225,1118,2410,0.464,806,1548,0.521,312,862,0.362,541,728,0.743,3089,2018,19
23,Kansas,2010-11,38,35,3,0.921,7625,1114,2193,0.508,843,1483,0.568,271,710,0.382,585,862,0.679,3084,2010,11
24,Northern Colo.,2017-18,38,26,12,0.684,7675,1104,2347,0.47,770,1417,0.543,334,930,0.359,540,784,0.689,3080,2017,18
25,Oregon,2016-17,39,33,6,0.846,7825,1091,2270,0.481,757,1390,0.545,334,880,0.38,560,787,0.712,3076,2016,17
26,Lipscomb,2018-19,37,29,8,0.784,7400,1071,2230,0.48,744,1354,0.549,327,876,0.373,607,801,0.758,3076,2018,19
27,Nevada,2017-18,37,29,8,0.784,7500,1049,2238,0.469,695,1334,0.521,354,904,0.392,603,812,0.743,3055,2017,18
28,Buffalo,2017-18,36,27,9,0.75,7275,1105,2334,0.473,754,1386,0.544,351,948,0.37,486,695,0.699,3047,2017,18
29,Buffalo,2018-19,36,32,4,0.889,7225,1083,2344,0.462,739,1322,0.559,344,1022,0.337,527,767,0.687,3037,2018,19
30,Tennessee,2018-19,37,31,6,0.838,7525,1106,2231,0.496,844,1517,0.556,262,714,0.367,561,744,0.754,3035,2018,19
31,Colorado,2010-11,38,24,14,0.632,7675,1058,2237,0.473,828,1619,0.511,230,618,0.372,679,873,0.778,3025,2010,11
32,Michigan State,2018-19,39,32,7,0.821,7852,1071,2230,0.48,752,1386,0.543,319,844,0.378,564,749,0.753,3025,2018,19
33,Oakland,2015-16,35,23,12,0.657,7025,1002,2186,0.458,686,1392,0.493,316,794,0.398,703,913,0.77,3023,2015,16
34,Michigan,2017-18,41,33,8,0.805,8275,1092,2335,0.468,731,1324,0.552,361,1011,0.357,474,717,0.661,3019,2017,18
35,UNC,2017-18,37,26,11,0.703,7425,1105,2417,0.457,800,1568,0.51,305,849,0.359,503,677,0.743,3018,2017,18
36,Marshall,2017-18,36,25,11,0.694,7275,1042,2232,0.467,680,1220,0.557,362,1012,0.358,571,747,0.764,3017,2017,18
37,West Virginia,2016-17,37,28,9,0.757,7525,1059,2333,0.454,784,1574,0.498,275,759,0.362,621,907,0.685,3014,2016,17
38,Green Bay,2015-16,36,23,13,0.639,7275,1048,2350,0.446,793,1620,0.49,255,730,0.349,662,1007,0.657,3013,2015,16
39,BYU,2010-11,37,32,5,0.865,7475,1019,2267,0.449,707,1402,0.504,312,865,0.361,662,865,0.765,3012,2010,11
40,UCLA,2013-14,37,28,9,0.757,7450,1073,2196,0.489,844,1593,0.53,229,603,0.38,628,839,0.749,3003,2013,14
41,Louisiana Tech,2013-14,37,29,8,0.784,7425,1034,2284,0.453,748,1416,0.528,286,868,0.329,644,948,0.679,2998,2013,14
42,Louisville,2013-14,37,31,6,0.838,7400,1051,2232,0.471,763,1449,0.527,288,783,0.368,608,920,0.661,2998,2013,14
43,Marshall,2016-17,35,20,15,0.571,7075,1021,2237,0.456,665,1275,0.522,356,962,0.37,599,816,0.734,2997,2016,17
44,Kansas,2016-17,36,31,5,0.861,7275,1071,2193,0.488,753,1406,0.536,318,787,0.404,535,789,0.678,2995,2016,17
45,Duke,2010-11,37,32,5,0.865,7400,1040,2206,0.471,749,1428,0.525,291,778,0.374,622,826,0.753,2993,2010,11
46,Oakland,2010-11,35,25,10,0.714,7025,1052,2137,0.492,765,1370,0.558,287,767,0.374,601,834,0.721,2992,2010,11
47,Kentucky,2013-14,40,29,11,0.725,8074,1004,2213,0.454,801,1602,0.5,203,611,0.332,781,1146,0.682,2992,2013,14
48,Duke,2016-17,37,28,9,0.757,7400,1019,2145,0.475,708,1324,0.535,311,821,0.379,642,842,0.762,2991,2016,17
49,Oregon,2015-16,38,31,7,0.816,7626,1041,2230,0.467,781,1472,0.531,260,758,0.343,648,906,0.715,2990,2015,16
50,Iowa State,2013-14,36,28,8,0.778,7324,1062,2239,0.474,761,1399,0.544,301,840,0.358,564,814,0.693,2989,2013,14
51,Gonzaga,2014-15,38,35,3,0.921,7625,1084,2083,0.52,820,1423,0.576,264,660,0.4,557,806,0.691,2989,2014,15
52,Western Ky.,2017-18,38,27,11,0.711,7625,1075,2183,0.492,869,1596,0.544,206,587,0.351,623,869,0.717,2979,2017,18
53,Louisville,2012-13,40,35,5,0.875,8125,1048,2300,0.456,818,1609,0.508,230,691,0.333,652,920,0.709,2978,2012,13
54,Marshall,2018-19,37,23,14,0.622,7475,1047,2367,0.442,685,1309,0.523,362,1058,0.342,522,723,0.722,2978,2018,19
55,Purdue,2017-18,37,30,7,0.811,7425,1033,2097,0.493,680,1257,0.541,353,840,0.42,555,747,0.743,2974,2017,18
56,UConn,2010-11,41,32,9,0.78,8350,1053,2429,0.434,819,1718,0.477,234,711,0.329,627,822,0.763,2967,2010,11
57,UNC Wilmington,2016-17,35,29,6,0.829,7025,1071,2231,0.48,735,1314,0.559,336,917,0.366,489,708,0.691,2967,2016,17
58,Citadel,2016-17,33,12,21,0.364,6675,980,2357,0.416,583,1192,0.489,397,1165,0.341,607,802,0.757,2964,2016,17
59,West Virginia,2017-18,37,26,11,0.703,7425,1036,2374,0.436,714,1463,0.488,322,911,0.353,570,744,0.766,2964,2017,18
60,Notre Dame,2014-15,38,32,6,0.842,7725,1050,2061,0.509,748,1286,0.582,302,775,0.39,561,756,0.742,2963,2014,15
61,Wyoming,2016-17,38,23,15,0.605,7725,986,2265,0.435,617,1210,0.51,369,1055,0.35,620,849,0.73,2961,2016,17
62,S Dakota St.,2017-18,35,28,7,0.8,7075,1003,2147,0.467,629,1220,0.516,374,927,0.403,578,759,0.762,2958,2017,18
63,UNC,2014-15,38,26,12,0.684,7650,1099,2309,0.476,915,1795,0.51,184,514,0.358,571,814,0.701,2953,2014,15
64,Xavier,2017-18,35,29,6,0.829,7075,1011,2055,0.492,737,1319,0.559,274,736,0.372,657,843,0.779,2953,2017,18
65,Oklahoma,2015-16,37,29,8,0.784,7476,1018,2225,0.458,636,1319,0.482,382,906,0.422,530,734,0.722,2948,2015,16
66,Michigan,2012-13,39,31,8,0.795,7876,1093,2260,0.484,797,1491,0.535,296,769,0.385,450,642,0.701,2932,2012,13
67,BYU,2013-14,35,23,12,0.657,7123,1012,2186,0.463,835,1687,0.495,177,499,0.355,730,1055,0.692,2931,2013,14
68,BYU,2014-15,35,25,10,0.714,7100,976,2090,0.467,676,1327,0.509,300,763,0.393,679,886,0.766,2931,2014,15
69,Iona,2010-11,37,25,12,0.676,7500,1048,2200,0.476,750,1405,0.534,298,795,0.375,528,804,0.657,2922,2010,11
70,Duke,2015-16,36,25,11,0.694,7250,983,2136,0.46,655,1285,0.51,328,851,0.385,626,866,0.723,2920,2015,16
71,Hofstra,2018-19,35,27,8,0.771,7201,998,2055,0.486,690,1255,0.55,308,800,0.385,615,767,0.802,2919,2018,19
72,Wichita State,2016-17,36,31,5,0.861,7200,992,2114,0.469,682,1345,0.507,310,769,0.403,622,848,0.733,2916,2016,17
73,Penn State,2017-18,39,26,13,0.667,7850,1057,2291,0.461,763,1532,0.498,294,759,0.387,507,722,0.702,2915,2017,18
74,TCU,2016-17,39,24,15,0.615,7850,1064,2284,0.466,784,1494,0.525,280,790,0.354,506,738,0.686,2914,2016,17
75,Ohio State,2011-12,39,31,8,0.795,7800,1057,2219,0.476,858,1623,0.529,199,596,0.334,600,846,0.709,2913,2011,12
76,Arizona,2014-15,38,34,4,0.895,7625,1009,2068,0.488,816,1532,0.533,193,536,0.36,700,974,0.719,2911,2014,15
77,Washington,2010-11,35,24,11,0.686,7050,1061,2260,0.469,756,1439,0.525,305,821,0.371,480,712,0.674,2907,2010,11
78,Arizona,2010-11,38,30,8,0.789,7700,969,2064,0.469,673,1319,0.51,296,745,0.397,671,899,0.746,2905,2010,11
79,Kentucky,2014-15,39,38,1,0.974,7873,1006,2150,0.468,803,1568,0.512,203,582,0.349,685,943,0.726,2900,2014,15
80,Wisconsin,2014-15,40,36,4,0.9,8050,1014,2115,0.479,726,1325,0.548,288,790,0.365,584,765,0.763,2900,2014,15
81,Portland State,2017-18,34,20,14,0.588,6874,1034,2333,0.443,734,1450,0.506,300,883,0.34,529,751,0.704,2897,2017,18
82,Central Mich.,2018-19,35,23,12,0.657,7125,991,2177,0.455,686,1355,0.506,305,822,0.371,609,908,0.671,2896,2018,19
83,Indiana,2015-16,35,27,8,0.771,7025,1021,2034,0.502,676,1203,0.562,345,831,0.415,504,688,0.733,2891,2015,16
84,Troy,2016-17,37,22,15,0.595,7426,982,2153,0.456,671,1286,0.522,311,867,0.359,614,847,0.725,2889,2016,17
85,NC State,2018-19,36,24,12,0.667,7250,1061,2319,0.458,769,1489,0.516,292,830,0.352,468,661,0.708,2882,2018,19
86,Memphis,2018-19,36,22,14,0.611,7224,1013,2238,0.453,753,1431,0.526,260,807,0.322,596,835,0.714,2882,2018,19
87,Wofford,2018-19,35,30,5,0.857,7050,1044,2132,0.49,659,1203,0.548,385,929,0.414,406,577,0.704,2879,2018,19
88,Nevada,2015-16,38,24,14,0.632,7750,973,2293,0.424,771,1635,0.472,202,658,0.307,730,992,0.736,2878,2015,16
89,Belmont,2013-14,36,26,10,0.722,7201,983,1973,0.498,660,1150,0.574,323,823,0.392,587,794,0.739,2876,2013,14
90,Oakland,2011-12,36,20,16,0.556,7276,947,2104,0.45,612,1209,0.506,335,895,0.374,646,877,0.737,2875,2011,12
91,George Washington,2015-16,38,28,10,0.737,7650,980,2194,0.447,711,1468,0.484,269,726,0.371,646,858,0.753,2875,2015,16
92,UConn,2013-14,40,32,8,0.8,8050,971,2163,0.449,684,1422,0.481,287,741,0.387,644,829,0.777,2873,2013,14
93,Florida State,2016-17,35,26,9,0.743,7000,1036,2146,0.483,803,1475,0.544,233,671,0.347,568,824,0.689,2873,2016,17
94,Michigan State,2013-14,38,29,9,0.763,7674,1024,2159,0.474,717,1376,0.521,307,783,0.392,515,728,0.707,2870,2013,14
95,Fort Wayne,2016-17,33,20,13,0.606,6700,1055,2127,0.496,703,1251,0.562,352,876,0.402,407,561,0.725,2869,2016,17
96,UNC,2010-11,37,29,8,0.784,7424,1044,2317,0.451,854,1738,0.491,190,579,0.328,590,878,0.672,2868,2010,11
97,Belmont,2018-19,33,27,6,0.818,6650,1042,2094,0.498,699,1172,0.596,343,922,0.372,441,598,0.737,2868,2018,19
98,Kansas,2011-12,39,32,7,0.821,7825,1023,2169,0.472,801,1526,0.525,222,643,0.345,597,863,0.692,2865,2011,12
99,North Florida,2015-16,34,22,12,0.647,6800,1000,2065,0.484,589,1063,0.554,411,1002,0.41,454,624,0.728,2865,2015,16
100,VCU,2010-11,40,28,12,0.7,8100,968,2228,0.434,629,1311,0.48,339,917,0.37,589,824,0.715,2864,2010,11
,,,,,,,,School,School,School,School,School,School,School,School,School,School,School,School,School,,
,Schl,Season,G,W,L,W-L%,MP,FG,FGA,FG%,2P,2PA,2P%,3P,3PA,3P%,FT,FTA,FT%,PTS,Season,
101,Creighton,2016-17,35,25,10,0.714,7000,1078,2137,0.504,774,1371,0.565,304,766,0.397,404,592,0.682,2864,2016,17
102,Iowa State,2015-16,35,23,12,0.657,7075,1087,2159,0.503,794,1401,0.567,293,758,0.387,395,563,0.702,2862,2015,16
103,Kentucky,2015-16,36,27,9,0.75,7275,1028,2149,0.478,784,1483,0.529,244,666,0.366,561,813,0.69,2861,2015,16
104,Monmouth,2015-16,36,28,8,0.778,7250,963,2214,0.435,681,1444,0.472,282,770,0.366,653,850,0.768,2861,2015,16
105,Arkansas,2016-17,36,26,10,0.722,7200,997,2165,0.461,764,1527,0.5,233,638,0.365,628,825,0.761,2855,2016,17
106,Ohio State,2010-11,37,34,3,0.919,7425,1017,2059,0.494,732,1385,0.529,285,674,0.423,535,763,0.701,2854,2010,11
107,Washington,2015-16,34,19,15,0.559,6925,964,2264,0.426,715,1512,0.473,249,752,0.331,676,932,0.725,2853,2015,16
108,Rice,2016-17,35,23,12,0.657,7075,946,2048,0.462,620,1208,0.513,326,840,0.388,635,858,0.74,2853,2016,17
109,Michigan,2016-17,38,26,12,0.684,7675,1002,2076,0.483,641,1139,0.563,361,937,0.385,486,624,0.779,2851,2016,17
110,UMass,2011-12,37,25,12,0.676,7500,1016,2341,0.434,728,1516,0.48,288,825,0.349,527,783,0.673,2847,2011,12
111,Fla. Gulf Coast,2017-18,35,23,12,0.657,7000,1045,2117,0.494,791,1418,0.558,254,699,0.363,503,680,0.74,2847,2017,18
112,Hampton,2018-19,35,18,17,0.514,7149,966,2236,0.432,675,1392,0.485,291,844,0.345,622,790,0.787,2847,2018,19
113,Marquette,2017-18,35,21,14,0.6,7075,989,2081,0.475,604,1157,0.522,385,924,0.417,483,600,0.805,2846,2017,18
114,Kentucky,2010-11,38,29,9,0.763,7625,1002,2183,0.459,721,1476,0.488,281,707,0.397,560,789,0.71,2845,2010,11
115,Baylor,2013-14,38,26,12,0.684,7698,959,2108,0.455,679,1383,0.491,280,725,0.386,645,949,0.68,2843,2013,14
116,Oregon State,2011-12,36,21,15,0.583,7350,995,2093,0.475,774,1477,0.524,221,616,0.359,630,931,0.677,2841,2011,12
117,Gonzaga,2015-16,36,28,8,0.778,7225,1011,2081,0.486,730,1343,0.544,281,738,0.381,537,708,0.758,2840,2015,16
118,Kentucky,2017-18,37,26,11,0.703,7425,998,2115,0.472,803,1569,0.512,195,546,0.357,649,930,0.698,2840,2017,18
119,Baylor,2011-12,38,30,8,0.789,7625,1004,2148,0.467,745,1472,0.506,259,676,0.383,572,759,0.754,2839,2011,12
120,Marshall,2015-16,33,17,16,0.515,6650,1017,2183,0.466,685,1198,0.572,332,985,0.337,472,681,0.693,2838,2015,16
121,Fresno State,2013-14,39,21,18,0.538,7950,950,2170,0.438,659,1355,0.486,291,815,0.357,646,884,0.731,2837,2013,14
122,Bucknell,2017-18,35,25,10,0.714,7100,965,2050,0.471,685,1246,0.55,280,804,0.348,627,872,0.719,2837,2017,18
123,Mercer,2013-14,36,27,9,0.75,7462,982,2061,0.476,692,1305,0.53,290,756,0.384,582,791,0.736,2836,2013,14
124,Xavier,2016-17,38,24,14,0.632,7625,981,2148,0.457,714,1372,0.52,267,776,0.344,607,881,0.689,2836,2016,17
125,Louisiana,2013-14,35,23,12,0.657,7149,988,2127,0.465,742,1457,0.509,246,670,0.367,613,913,0.671,2835,2013,14
126,Central Mich.,2017-18,36,21,15,0.583,7325,953,2187,0.436,597,1150,0.519,356,1037,0.343,573,711,0.806,2835,2017,18
127,Samford,2016-17,36,20,16,0.556,7450,955,2038,0.469,676,1331,0.508,279,707,0.395,645,868,0.743,2834,2016,17
128,Coastal Caro.,2016-17,39,20,19,0.513,7850,1021,2416,0.423,703,1453,0.484,318,963,0.33,473,719,0.658,2833,2016,17
129,Arizona,2016-17,37,32,5,0.865,7400,977,2048,0.477,733,1423,0.515,244,625,0.39,635,830,0.765,2833,2016,17
130,South Dakota,2017-18,35,26,9,0.743,7000,1017,2136,0.476,774,1452,0.533,243,684,0.355,555,740,0.75,2832,2017,18
131,Belmont,2011-12,35,27,8,0.771,7050,975,2026,0.481,666,1209,0.551,309,817,0.378,572,779,0.734,2831,2011,12
132,Indiana,2012-13,36,29,7,0.806,7253,951,1971,0.482,694,1334,0.52,257,637,0.403,672,904,0.743,2831,2012,13
133,Iowa State,2016-17,35,24,11,0.686,7125,1031,2186,0.472,687,1326,0.518,344,860,0.4,423,604,0.7,2829,2016,17
134,Louisiana,2017-18,34,27,7,0.794,6825,971,2093,0.464,674,1275,0.529,297,818,0.363,590,775,0.761,2829,2017,18
135,Texas A&M,2015-16,37,28,9,0.757,7500,991,2208,0.449,710,1384,0.513,281,824,0.341,565,841,0.672,2828,2015,16
136,Oklahoma State,2016-17,33,20,13,0.606,6601,957,2050,0.467,663,1318,0.503,294,732,0.402,620,786,0.789,2828,2016,17
137,North Texas,2017-18,38,20,18,0.526,7699,1012,2243,0.451,710,1394,0.509,302,849,0.356,502,761,0.66,2828,2017,18
138,Santa Clara,2012-13,38,26,12,0.684,7650,970,2195,0.442,667,1355,0.492,303,840,0.361,584,803,0.727,2827,2012,13
139,Central Mich.,2016-17,32,16,16,0.5,6475,912,2153,0.424,513,1038,0.494,399,1115,0.358,603,762,0.791,2826,2016,17
140,Charleston,2010-11,37,26,11,0.703,7401,1037,2173,0.477,731,1338,0.546,306,835,0.366,441,595,0.741,2821,2010,11
141,DePaul,2018-19,36,19,17,0.528,7250,1009,2143,0.471,768,1440,0.533,241,703,0.343,562,773,0.727,2821,2018,19
142,Eastern Wash.,2014-15,35,26,9,0.743,7050,977,2045,0.478,633,1185,0.534,344,860,0.4,522,719,0.726,2820,2014,15
143,Central Ark.,2017-18,35,18,17,0.514,7124,980,2162,0.453,694,1358,0.511,286,804,0.356,573,780,0.735,2819,2017,18
144,Arkansas,2017-18,35,23,12,0.657,7075,1005,2119,0.474,736,1438,0.512,269,681,0.395,540,793,0.681,2819,2017,18
145,Stephen F. Austin,2017-18,35,28,7,0.8,7000,1000,2059,0.486,758,1408,0.538,242,651,0.372,577,819,0.705,2819,2017,18
146,Texas-Arlington,2016-17,36,27,9,0.75,7199,999,2168,0.461,689,1248,0.552,310,920,0.337,510,749,0.681,2818,2016,17
147,Arizona,2017-18,35,27,8,0.771,7100,1009,2003,0.504,772,1361,0.567,237,642,0.369,563,741,0.76,2818,2017,18
148,Oregon,2017-18,36,23,13,0.639,7300,986,2155,0.458,662,1247,0.531,324,908,0.357,521,683,0.763,2817,2017,18
149,Presbyterian,2018-19,36,20,16,0.556,7225,966,2150,0.449,572,1116,0.513,394,1034,0.381,491,674,0.728,2817,2018,19
150,Syracuse,2012-13,40,30,10,0.75,8050,1007,2293,0.439,774,1597,0.485,233,696,0.335,569,843,0.675,2816,2012,13
151,USC,2016-17,36,26,10,0.722,7227,975,2139,0.456,692,1357,0.51,283,782,0.362,583,787,0.741,2816,2016,17
152,LSU,2018-19,35,28,7,0.8,7176,988,2162,0.457,752,1422,0.529,236,740,0.319,603,802,0.752,2815,2018,19
153,Missouri,2011-12,35,30,5,0.857,7025,981,1945,0.504,688,1208,0.57,293,737,0.398,559,730,0.766,2814,2011,12
154,ETSU,2015-16,36,24,12,0.667,7275,984,2135,0.461,689,1356,0.508,295,779,0.379,550,774,0.711,2813,2015,16
155,Iona,2016-17,35,22,13,0.629,7075,979,2155,0.454,637,1293,0.493,342,862,0.397,513,668,0.768,2813,2016,17
156,New Mexico St.,2011-12,36,26,10,0.722,7225,970,2045,0.474,805,1540,0.523,165,505,0.327,707,1058,0.668,2812,2011,12
157,Baylor,2012-13,37,23,14,0.622,7446,1002,2178,0.46,745,1450,0.514,257,728,0.353,550,796,0.691,2811,2012,13
158,Santa Clara,2010-11,38,24,14,0.632,7675,909,2112,0.43,636,1335,0.476,273,777,0.351,719,990,0.726,2810,2010,11
159,Florida,2011-12,37,26,11,0.703,7475,976,2106,0.463,619,1167,0.53,357,939,0.38,499,700,0.713,2808,2011,12
160,Ole Miss,2016-17,36,22,14,0.611,7250,914,2162,0.423,631,1347,0.468,283,815,0.347,696,926,0.752,2807,2016,17
161,Michigan State,2017-18,35,30,5,0.857,7025,991,1996,0.496,701,1271,0.552,290,725,0.4,535,716,0.747,2807,2017,18
162,Florida State,2017-18,35,23,12,0.657,7099,994,2125,0.468,721,1344,0.536,273,781,0.35,543,786,0.691,2806,2017,18
163,Kentucky,2018-19,37,30,7,0.811,7451,978,2050,0.477,763,1443,0.529,215,607,0.354,635,859,0.739,2806,2018,19
164,Florida,2016-17,36,27,9,0.75,7275,953,2119,0.45,675,1343,0.503,278,776,0.358,620,851,0.729,2804,2016,17
165,Lipscomb,2016-17,33,20,13,0.606,6625,939,1978,0.475,599,1050,0.57,340,928,0.366,586,811,0.723,2804,2016,17
166,Weber State,2012-13,37,30,7,0.811,7475,990,1957,0.506,724,1317,0.55,266,640,0.416,554,768,0.721,2800,2012,13
167,USC,2017-18,36,24,12,0.667,7300,1022,2174,0.47,726,1386,0.524,296,788,0.376,458,649,0.706,2798,2017,18
168,FIU,2018-19,34,20,14,0.588,6800,986,2239,0.44,707,1316,0.537,279,923,0.302,547,855,0.64,2798,2018,19
169,New Mexico,2017-18,34,19,15,0.559,6825,939,2065,0.455,572,1086,0.527,367,979,0.375,550,708,0.777,2795,2017,18
170,Wisconsin,2013-14,38,30,8,0.789,7625,927,2019,0.459,630,1229,0.513,297,790,0.376,642,861,0.746,2793,2013,14
171,Michigan State,2015-16,35,29,6,0.829,7050,1009,2078,0.486,688,1339,0.514,321,739,0.434,454,623,0.729,2793,2015,16
172,Nevada,2016-17,35,28,7,0.8,7025,933,2082,0.448,613,1245,0.492,320,837,0.382,606,859,0.705,2792,2016,17
173,Belmont,2010-11,35,30,5,0.857,7050,944,2045,0.462,617,1181,0.522,327,864,0.378,575,781,0.736,2790,2010,11
174,Purdue,2016-17,35,27,8,0.771,7075,980,2044,0.479,665,1262,0.527,315,782,0.403,515,680,0.757,2790,2016,17
175,Louisiana,2014-15,36,22,14,0.611,7250,975,2125,0.459,735,1455,0.505,240,670,0.358,599,848,0.706,2789,2014,15
176,S Dakota St.,2018-19,33,24,9,0.727,6600,984,1965,0.501,657,1163,0.565,327,802,0.408,494,635,0.778,2789,2018,19
177,Arkansas,2014-15,36,27,9,0.75,7252,978,2196,0.445,740,1515,0.488,238,681,0.349,593,819,0.724,2787,2014,15
178,Creighton,2015-16,35,20,15,0.571,7000,979,2081,0.47,696,1277,0.545,283,804,0.352,546,780,0.7,2787,2015,16
179,Texas Southern,2017-18,36,16,20,0.444,7251,925,2111,0.438,645,1330,0.485,280,781,0.359,657,906,0.725,2787,2017,18
180,Houston,2018-19,37,33,4,0.892,7401,982,2203,0.446,649,1264,0.513,333,939,0.355,490,697,0.703,2787,2018,19
181,Oregon,2013-14,34,24,10,0.706,6925,928,1977,0.469,669,1311,0.51,259,666,0.389,668,865,0.772,2783,2013,14
182,Notre Dame,2016-17,36,26,10,0.722,7226,980,2139,0.458,646,1270,0.509,334,869,0.384,489,611,0.8,2783,2016,17
183,Auburn,2017-18,34,26,8,0.765,6800,906,2102,0.431,582,1194,0.487,324,908,0.357,647,836,0.774,2783,2017,18
184,Marquette,2010-11,37,22,15,0.595,7425,973,2094,0.465,782,1547,0.505,191,547,0.349,645,927,0.696,2782,2010,11
185,Indiana,2011-12,36,27,9,0.75,7200,949,1928,0.492,720,1397,0.515,229,531,0.431,655,858,0.763,2782,2011,12
186,Kansas,2012-13,37,31,6,0.838,7525,985,2049,0.481,769,1455,0.529,216,594,0.364,596,809,0.737,2782,2012,13
187,Delaware,2013-14,35,25,10,0.714,7027,936,2108,0.444,684,1381,0.495,252,727,0.347,658,925,0.711,2782,2013,14
188,Iona,2014-15,35,26,9,0.743,7025,950,2051,0.463,606,1182,0.513,344,869,0.396,538,768,0.701,2782,2014,15
189,Valparaiso,2015-16,37,30,7,0.811,7450,964,2178,0.443,666,1349,0.494,298,829,0.359,556,769,0.723,2782,2015,16
190,ETSU,2016-17,35,27,8,0.771,7075,960,1967,0.488,695,1274,0.546,265,693,0.382,597,850,0.702,2782,2016,17
191,VCU,2015-16,36,25,11,0.694,7250,1010,2238,0.451,748,1493,0.501,262,745,0.352,499,721,0.692,2781,2015,16
192,St. Joseph's,2015-16,36,28,8,0.778,7225,976,2153,0.453,725,1386,0.523,251,767,0.327,577,806,0.716,2780,2015,16
193,Iowa State,2012-13,35,23,12,0.657,7100,962,2111,0.456,616,1187,0.519,346,924,0.374,509,696,0.731,2779,2012,13
194,Ole Miss,2012-13,36,27,9,0.75,7275,977,2230,0.438,739,1495,0.494,238,735,0.324,587,866,0.678,2779,2012,13
195,Villanova,2016-17,36,32,4,0.889,7200,965,1948,0.495,654,1105,0.592,311,843,0.369,538,681,0.79,2779,2016,17
196,Duke,2012-13,36,30,6,0.833,7200,960,2033,0.472,690,1357,0.508,270,676,0.399,588,796,0.739,2778,2012,13
197,Utah,2015-16,36,27,9,0.75,7301,977,2000,0.489,704,1254,0.561,273,746,0.366,551,764,0.721,2778,2015,16
198,BYU,2012-13,36,24,12,0.667,7200,999,2188,0.457,786,1558,0.504,213,630,0.338,566,777,0.728,2777,2012,13
199,Fort Wayne,2013-14,36,25,11,0.694,7224,975,1979,0.493,690,1253,0.551,285,726,0.393,539,813,0.663,2774,2013,14
200,Vermont,2015-16,37,23,14,0.622,7400,986,2051,0.481,731,1385,0.528,255,666,0.383,547,772,0.709,2774,2015,16
,,,,,,,,School,School,School,School,School,School,School,School,School,School,School,School,School,,
,Schl,Season,G,W,L,W-L%,MP,FG,FGA,FG%,2P,2PA,2P%,3P,3PA,3P%,FT,FTA,FT%,PTS,Season,
201,Michigan State,2014-15,39,27,12,0.692,8025,1014,2181,0.465,720,1418,0.508,294,763,0.385,451,714,0.632,2773,2014,15
202,La.-Monroe,2018-19,35,19,16,0.543,7125,922,2029,0.454,569,1138,0.5,353,891,0.396,576,737,0.782,2773,2018,19
203,Creighton,2011-12,35,29,6,0.829,7050,975,1935,0.504,688,1258,0.547,287,677,0.424,535,737,0.726,2772,2011,12
204,Kent State,2016-17,36,22,14,0.611,7325,986,2302,0.428,729,1499,0.486,257,803,0.32,543,755,0.719,2772,2016,17
205,Akron,2016-17,36,27,9,0.75,7201,949,2035,0.466,583,1051,0.555,366,984,0.372,508,744,0.683,2772,2016,17
206,Saint Mary's,2017-18,36,30,6,0.833,7275,1014,1970,0.515,730,1278,0.571,284,692,0.41,460,598,0.769,2772,2017,18
207,New Mexico St.,2013-14,36,26,10,0.722,7275,936,1918,0.488,742,1395,0.532,194,523,0.371,705,1027,0.686,2771,2013,14
208,Florida State,2018-19,37,29,8,0.784,7500,960,2171,0.442,688,1352,0.509,272,819,0.332,579,778,0.744,2771,2018,19
209,VCU,2012-13,36,27,9,0.75,7252,1010,2243,0.45,729,1443,0.505,281,800,0.351,469,669,0.701,2770,2012,13
210,LIU,2011-12,34,25,9,0.735,6825,920,1940,0.474,695,1334,0.521,225,606,0.371,704,965,0.73,2769,2011,12
211,Arizona,2013-14,38,33,5,0.868,7701,996,2123,0.469,792,1562,0.507,204,561,0.364,573,870,0.659,2769,2013,14
212,Eastern Wash.,2015-16,34,18,16,0.529,6800,961,1989,0.483,605,1065,0.568,356,924,0.385,491,719,0.683,2769,2015,16
213,Texas Tech,2018-19,38,31,7,0.816,7652,990,2110,0.469,713,1351,0.528,277,759,0.365,508,694,0.732,2765,2018,19
214,Kansas,2013-14,35,25,10,0.714,7048,955,1937,0.493,766,1381,0.555,189,556,0.34,665,935,0.711,2764,2013,14
215,Murray State,2014-15,35,29,6,0.829,7050,961,1995,0.482,698,1316,0.53,263,679,0.387,579,831,0.697,2764,2014,15
216,Butler,2017-18,35,21,14,0.6,7150,1020,2155,0.473,733,1350,0.543,287,805,0.357,436,562,0.776,2763,2017,18
217,Texas-Arlington,2015-16,35,24,11,0.686,7075,956,2249,0.425,649,1307,0.497,307,942,0.326,543,780,0.696,2762,2015,16
218,Gonzaga,2013-14,36,29,7,0.806,7105,972,1963,0.495,717,1320,0.543,255,643,0.397,562,793,0.709,2761,2013,14
219,Monmouth,2016-17,34,27,7,0.794,6875,929,2127,0.437,626,1314,0.476,303,813,0.373,600,793,0.757,2761,2016,17
220,UNC,2012-13,36,25,11,0.694,7225,1023,2321,0.441,751,1598,0.47,272,723,0.376,442,655,0.675,2760,2012,13
221,Iona,2013-14,33,22,11,0.667,6626,947,1944,0.487,609,1091,0.558,338,853,0.396,528,739,0.714,2760,2013,14
222,Hampton,2017-18,35,19,16,0.543,6850,970,2173,0.446,772,1546,0.499,198,627,0.316,565,727,0.777,2760,2017,18
223,Purdue,2018-19,36,26,10,0.722,7298,967,2145,0.451,602,1168,0.515,365,977,0.374,461,641,0.719,2760,2018,19
224,UMBC,2016-17,34,21,13,0.618,6950,957,2041,0.469,627,1201,0.522,330,840,0.393,515,691,0.745,2759,2016,17
225,Texas Tech,2017-18,37,27,10,0.73,7450,964,2096,0.46,712,1394,0.511,252,702,0.359,579,823,0.704,2759,2017,18
226,Oklahoma State,2017-18,36,21,15,0.583,7250,959,2224,0.431,663,1373,0.483,296,851,0.348,543,717,0.757,2757,2017,18
227,Creighton,2013-14,35,27,8,0.771,7000,957,1927,0.497,601,1068,0.563,356,859,0.414,486,654,0.743,2756,2013,14
228,Creighton,2017-18,33,21,12,0.636,6650,1008,2050,0.492,665,1127,0.59,343,923,0.372,397,531,0.748,2756,2017,18
229,Villanova,2014-15,36,33,3,0.917,7250,916,1951,0.47,590,1114,0.53,326,837,0.389,596,815,0.731,2754,2014,15
230,Savannah State,2017-18,32,15,17,0.469,6475,940,2350,0.4,549,1046,0.525,391,1304,0.3,483,694,0.696,2754,2017,18
231,Citadel,2015-16,32,10,22,0.313,6437,938,2242,0.418,575,1121,0.513,363,1121,0.324,514,704,0.73,2753,2015,16
232,UNLV,2017-18,33,20,13,0.606,6725,978,2000,0.489,793,1446,0.548,185,554,0.334,612,868,0.705,2753,2017,18
233,Utah State,2018-19,35,28,7,0.8,7050,959,2038,0.471,685,1266,0.541,274,772,0.355,559,747,0.748,2753,2018,19
234,South Florida,2018-19,38,24,14,0.632,7775,911,2120,0.43,639,1301,0.491,272,819,0.332,658,1018,0.646,2752,2018,19
235,West Virginia,2015-16,35,26,9,0.743,7050,943,2102,0.449,734,1459,0.503,209,643,0.325,654,972,0.673,2749,2015,16
236,UIC,2016-17,36,17,19,0.472,7275,939,2113,0.444,667,1367,0.488,272,746,0.365,599,843,0.711,2749,2016,17
237,Missouri,2010-11,34,23,11,0.676,6875,983,2145,0.458,738,1476,0.5,245,669,0.366,537,727,0.739,2748,2010,11
238,Niagara,2017-18,33,19,14,0.576,6650,944,2124,0.444,672,1366,0.492,272,758,0.359,588,808,0.728,2748,2017,18
239,Northern Ky.,2018-19,35,26,9,0.743,7050,979,2047,0.478,673,1203,0.559,306,844,0.363,483,725,0.666,2747,2018,19
240,Ohio,2015-16,35,23,12,0.657,7050,937,1993,0.47,641,1226,0.523,296,767,0.386,576,759,0.759,2746,2015,16
241,UNC Asheville,2011-12,34,24,10,0.706,6824,920,1907,0.482,697,1278,0.545,223,629,0.355,682,893,0.764,2745,2011,12
242,Duke,2013-14,35,26,9,0.743,7025,929,2020,0.46,613,1219,0.503,316,801,0.395,571,783,0.729,2745,2013,14
243,BYU,2016-17,34,22,12,0.647,6800,937,2057,0.456,707,1389,0.509,230,668,0.344,637,869,0.733,2741,2016,17
244,Syracuse,2011-12,37,34,3,0.919,7425,1006,2156,0.467,773,1488,0.519,233,668,0.349,495,709,0.698,2740,2011,12
245,Austin Peay,2015-16,36,18,18,0.5,7300,945,2049,0.461,722,1404,0.514,223,645,0.346,627,936,0.67,2740,2015,16
246,UTSA,2017-18,35,20,15,0.571,7019,972,2224,0.437,619,1245,0.497,353,979,0.361,443,656,0.675,2740,2017,18
247,Iowa,2018-19,35,23,12,0.657,7075,914,2006,0.456,629,1224,0.514,285,782,0.364,627,849,0.739,2740,2018,19
248,Iowa,2016-17,34,19,15,0.559,6975,964,2121,0.455,664,1330,0.499,300,791,0.379,510,741,0.688,2738,2016,17
249,UNC Greensboro,2018-19,36,29,7,0.806,7225,997,2184,0.457,717,1366,0.525,280,818,0.342,464,666,0.697,2738,2018,19
250,USC,2015-16,34,21,13,0.618,6900,982,2138,0.459,716,1450,0.494,266,688,0.387,507,750,0.676,2737,2015,16
251,Xavier,2015-16,34,28,6,0.824,6800,928,2054,0.452,673,1352,0.498,255,702,0.363,626,857,0.73,2737,2015,16
252,Iona,2011-12,33,25,8,0.758,6676,1021,2033,0.502,767,1377,0.557,254,656,0.387,440,617,0.713,2736,2011,12
253,Michigan,2013-14,37,28,9,0.757,7450,945,1982,0.477,626,1188,0.527,319,794,0.402,527,691,0.763,2736,2013,14
254,Oregon,2010-11,39,21,18,0.538,7827,971,2286,0.425,698,1481,0.471,273,805,0.339,520,704,0.739,2735,2010,11
255,Arizona,2015-16,34,25,9,0.735,6950,946,1970,0.48,725,1390,0.522,221,580,0.381,622,863,0.721,2735,2015,16
256,New Mexico St.,2018-19,35,30,5,0.857,7019,962,2092,0.46,636,1115,0.57,326,977,0.334,484,714,0.678,2734,2018,19
257,Iona,2012-13,34,20,14,0.588,6975,956,2106,0.454,673,1335,0.504,283,771,0.367,538,689,0.781,2733,2012,13
258,Southern Miss,2012-13,37,27,10,0.73,7525,985,2058,0.479,740,1413,0.524,245,645,0.38,518,746,0.694,2733,2012,13
259,Wake Forest,2016-17,33,19,14,0.576,6600,923,1955,0.472,655,1258,0.521,268,697,0.385,619,795,0.779,2733,2016,17
260,Wichita State,2017-18,33,25,8,0.758,6650,957,2009,0.476,657,1222,0.538,300,787,0.381,517,700,0.739,2731,2017,18
261,LIU,2010-11,33,27,6,0.818,6654,928,2009,0.462,699,1374,0.509,229,635,0.361,645,999,0.646,2730,2010,11
262,TCU,2018-19,37,23,14,0.622,7500,990,2168,0.457,709,1355,0.523,281,813,0.346,469,688,0.682,2730,2018,19
263,Radford,2013-14,35,22,13,0.629,7025,972,2035,0.478,751,1425,0.527,221,610,0.362,564,820,0.688,2729,2013,14
264,Omaha,2015-16,32,18,14,0.563,6475,953,2023,0.471,751,1424,0.527,202,599,0.337,621,833,0.745,2729,2015,16
265,Stetson,2015-16,34,12,22,0.353,6951,962,2124,0.453,680,1351,0.503,282,773,0.365,523,725,0.721,2729,2015,16
266,Oklahoma State,2013-14,34,21,13,0.618,6954,898,1941,0.463,659,1285,0.513,239,656,0.364,693,964,0.719,2728,2013,14
267,Stephen F. Austin,2015-16,34,28,6,0.824,6799,972,2032,0.478,703,1291,0.545,269,741,0.363,515,701,0.735,2728,2015,16
268,Fort Wayne,2018-19,33,18,15,0.545,6650,991,2059,0.481,631,1110,0.568,360,949,0.379,386,557,0.693,2728,2018,19
269,Louisville,2011-12,40,30,10,0.75,8100,963,2281,0.422,730,1548,0.472,233,733,0.318,568,826,0.688,2727,2011,12
270,BYU,2011-12,35,26,9,0.743,7000,977,2099,0.465,744,1420,0.524,233,679,0.343,540,771,0.7,2727,2011,12
271,Florida,2013-14,39,36,3,0.923,7799,945,2056,0.46,690,1345,0.513,255,711,0.359,582,871,0.668,2727,2013,14
272,Creighton,2018-19,35,20,15,0.571,7100,980,2044,0.479,608,1083,0.561,372,961,0.387,395,582,0.679,2727,2018,19
273,Murray State,2018-19,33,28,5,0.848,6600,988,2007,0.492,730,1276,0.572,258,731,0.353,493,673,0.733,2727,2018,19
274,VMI,2010-11,31,18,13,0.581,6225,935,2082,0.449,584,1104,0.529,351,978,0.359,505,712,0.709,2726,2010,11
275,Purdue,2015-16,35,26,9,0.743,7075,960,2042,0.47,692,1311,0.528,268,731,0.367,538,723,0.744,2726,2015,16
276,Ga. Southern,2018-19,33,21,12,0.636,6650,1012,2028,0.499,808,1396,0.579,204,632,0.323,498,720,0.692,2726,2018,19
277,Maryland,2015-16,36,27,9,0.75,7225,943,1941,0.486,676,1202,0.562,267,739,0.361,572,745,0.768,2725,2015,16
278,Kansas,2018-19,36,26,10,0.722,7275,989,2128,0.465,729,1385,0.526,260,743,0.35,487,691,0.705,2725,2018,19
279,Arkansas,2013-14,34,22,12,0.647,6878,928,2105,0.441,675,1407,0.48,253,698,0.362,614,846,0.726,2723,2013,14
280,Nevada,2018-19,34,29,5,0.853,6800,924,1999,0.462,627,1144,0.548,297,855,0.347,578,816,0.708,2723,2018,19
281,Loyola (IL),2017-18,38,32,6,0.842,7600,995,1963,0.507,718,1263,0.568,277,700,0.396,454,626,0.725,2721,2017,18
282,Louisville,2017-18,36,22,14,0.611,7300,969,2140,0.453,689,1386,0.497,280,754,0.371,503,683,0.736,2721,2017,18
283,Wichita State,2012-13,39,30,9,0.769,7800,954,2166,0.44,695,1401,0.496,259,765,0.339,553,791,0.699,2720,2012,13
284,Morehead State,2015-16,37,23,14,0.622,7475,974,2219,0.439,759,1626,0.467,215,593,0.363,557,801,0.695,2720,2015,16
285,Oklahoma,2017-18,32,18,14,0.563,6475,954,2063,0.462,654,1227,0.533,300,836,0.359,510,684,0.746,2718,2017,18
286,Gardner-Webb,2018-19,35,23,12,0.657,7151,955,1962,0.487,674,1243,0.542,281,719,0.391,527,741,0.711,2718,2018,19
287,Miss. St.,2017-18,37,25,12,0.676,7451,1000,2151,0.465,744,1349,0.552,256,802,0.319,460,666,0.691,2716,2017,18
288,Fort Wayne,2017-18,33,18,15,0.545,6625,953,2073,0.46,614,1148,0.535,339,925,0.366,471,654,0.72,2716,2017,18
289,Minnesota,2013-14,38,25,13,0.658,7725,918,2053,0.447,646,1280,0.505,272,773,0.352,607,818,0.742,2715,2013,14
290,Tx AM-CC,2016-17,36,24,12,0.667,7275,974,2071,0.47,779,1483,0.525,195,588,0.332,572,792,0.722,2715,2016,17
291,Virginia,2018-19,38,35,3,0.921,7674,974,2056,0.474,653,1243,0.525,321,813,0.395,445,598,0.744,2714,2018,19
292,Oregon,2014-15,36,26,10,0.722,7300,992,2143,0.463,729,1417,0.514,263,726,0.362,466,613,0.76,2713,2014,15
293,Xavier,2014-15,37,23,14,0.622,7525,956,2011,0.475,722,1345,0.537,234,666,0.351,566,775,0.73,2712,2014,15
294,Weber State,2016-17,34,20,14,0.588,6900,908,1866,0.487,596,1117,0.534,312,749,0.417,584,788,0.741,2712,2016,17
295,Austin Peay,2018-19,33,22,11,0.667,6675,973,2060,0.472,705,1358,0.519,268,702,0.382,498,705,0.706,2712,2018,19
296,Indiana,2016-17,34,18,16,0.529,6950,959,2004,0.479,664,1228,0.541,295,776,0.38,498,683,0.729,2711,2016,17
297,Buffalo,2015-16,35,20,15,0.571,7050,915,2096,0.437,652,1320,0.494,263,776,0.339,616,867,0.71,2709,2015,16
298,NC State,2012-13,35,24,11,0.686,7026,985,1987,0.496,801,1516,0.528,184,471,0.391,554,813,0.681,2708,2012,13
299,Lipscomb,2017-18,33,23,10,0.697,6700,924,2040,0.453,657,1227,0.535,267,813,0.328,593,826,0.718,2708,2017,18
300,UIC,2017-18,36,20,16,0.556,7225,951,2115,0.45,709,1418,0.5,242,697,0.347,564,768,0.734,2708,2017,18
,,,,,,,,School,School,School,School,School,School,School,School,School,School,School,School,School,,
,Schl,Season,G,W,L,W-L%,MP,FG,FGA,FG%,2P,2PA,2P%,3P,3PA,3P%,FT,FTA,FT%,PTS,Season,
301,TCU,2017-18,33,21,12,0.636,6725,979,1973,0.496,705,1279,0.551,274,694,0.395,476,674,0.706,2708,2017,18
302,Butler,2010-11,38,28,10,0.737,7700,919,2122,0.433,630,1300,0.485,289,822,0.352,580,799,0.726,2707,2010,11
303,South Carolina,2016-17,37,26,11,0.703,7525,924,2197,0.421,676,1464,0.462,248,733,0.338,611,874,0.699,2707,2016,17
304,ETSU,2018-19,34,24,10,0.706,6875,1004,2067,0.486,730,1309,0.558,274,758,0.361,425,634,0.67,2707,2018,19
305,Wichita State,2013-14,36,35,1,0.972,7223,896,1942,0.461,646,1229,0.526,250,713,0.351,664,916,0.725,2706,2013,14
306,UC-Irvine,2015-16,38,28,10,0.737,7675,977,2128,0.459,736,1476,0.499,241,652,0.37,511,752,0.68,2706,2015,16
307,Louisiana,2015-16,34,19,15,0.559,6850,931,2099,0.444,709,1383,0.513,222,716,0.31,622,891,0.698,2706,2015,16
308,Oklahoma,2013-14,33,23,10,0.697,6676,909,2034,0.447,624,1282,0.487,285,752,0.379,601,802,0.749,2704,2013,14
309,Duquesne,2015-16,34,17,17,0.5,6850,950,2056,0.462,628,1173,0.535,322,883,0.365,482,698,0.691,2704,2015,16
310,Notre Dame,2015-16,36,24,12,0.667,7225,972,2042,0.476,710,1342,0.529,262,700,0.374,498,671,0.742,2704,2015,16
311,Louisiana,2016-17,33,21,12,0.636,6627,945,2022,0.467,714,1349,0.529,231,673,0.343,583,839,0.695,2704,2016,17
312,Fla. Gulf Coast,2015-16,35,21,14,0.6,7176,1008,2106,0.479,822,1579,0.521,186,527,0.353,501,778,0.644,2703,2015,16
313,Iona,2017-18,34,20,14,0.588,6925,957,2076,0.461,633,1230,0.515,324,846,0.383,462,626,0.738,2702,2017,18
314,Texas,2010-11,36,28,8,0.778,7250,954,2099,0.455,753,1564,0.481,201,535,0.376,592,905,0.654,2701,2010,11
315,Fort Wayne,2015-16,34,24,10,0.706,6850,932,2017,0.462,578,1154,0.501,354,863,0.41,483,671,0.72,2701,2015,16
316,Fla. Gulf Coast,2016-17,34,26,8,0.765,6850,1007,2017,0.499,786,1381,0.569,221,636,0.347,466,664,0.702,2701,2016,17
317,Seton Hall,2017-18,34,22,12,0.647,6850,971,2073,0.468,721,1388,0.519,250,685,0.365,509,729,0.698,2701,2017,18
318,Colorado State,2015-16,34,18,16,0.529,6999,878,2067,0.425,552,1171,0.471,326,896,0.364,618,861,0.718,2700,2015,16
319,Oakland,2016-17,34,25,9,0.735,6825,935,2057,0.455,688,1319,0.522,247,738,0.335,582,765,0.761,2699,2016,17
320,Notre Dame,2017-18,36,21,15,0.583,7275,945,2131,0.443,645,1293,0.499,300,838,0.358,508,670,0.758,2698,2017,18
321,NC State,2011-12,37,24,13,0.649,7425,977,2134,0.458,779,1577,0.494,198,557,0.355,545,774,0.704,2697,2011,12
322,Middle Tenn.,2016-17,36,31,5,0.861,7225,1014,2077,0.488,786,1455,0.54,228,622,0.367,441,631,0.699,2697,2016,17
323,Utah Valley,2018-19,35,25,10,0.714,6996,930,1929,0.482,647,1189,0.544,283,740,0.382,554,764,0.725,2697,2018,19
324,Gonzaga,2012-13,35,32,3,0.914,7000,961,1934,0.497,735,1325,0.555,226,609,0.371,548,777,0.705,2696,2012,13
325,Fla. Gulf Coast,2012-13,37,26,11,0.703,7475,976,2112,0.462,729,1390,0.524,247,722,0.342,497,736,0.675,2696,2012,13
326,LIU,2017-18,35,18,17,0.514,7025,935,2055,0.455,656,1240,0.529,279,815,0.342,547,786,0.696,2696,2017,18
327,Eastern Wash.,2016-17,34,22,12,0.647,7050,947,1975,0.479,666,1234,0.54,281,741,0.379,520,675,0.77,2695,2016,17
328,Toledo,2013-14,34,27,7,0.794,6851,929,1996,0.465,736,1436,0.513,193,560,0.345,643,887,0.725,2694,2013,14
329,UT-Martin,2016-17,35,22,13,0.629,7076,966,2066,0.468,679,1254,0.541,287,812,0.353,474,689,0.688,2693,2016,17
330,Pitt,2011-12,39,22,17,0.564,7825,981,2164,0.453,734,1457,0.504,247,707,0.349,483,691,0.699,2692,2011,12
331,Iowa State,2018-19,35,23,12,0.657,7000,974,2047,0.476,680,1236,0.55,294,811,0.363,450,615,0.732,2692,2018,19
332,UMKC,2016-17,35,18,17,0.514,7025,911,2076,0.439,596,1228,0.485,315,848,0.371,554,777,0.713,2691,2016,17
333,Wichita State,2010-11,37,29,8,0.784,7500,954,2037,0.468,694,1304,0.532,260,733,0.355,522,700,0.746,2690,2010,11
334,S Dakota St.,2011-12,35,27,8,0.771,7075,918,1963,0.468,634,1235,0.513,284,728,0.39,569,783,0.727,2689,2011,12
335,Cal St Northridge,2013-14,35,17,18,0.486,7207,888,1955,0.454,740,1552,0.477,148,403,0.367,765,967,0.791,2689,2013,14
336,ETSU,2013-14,35,19,16,0.543,7049,879,2045,0.43,604,1287,0.469,275,758,0.363,656,877,0.748,2689,2013,14
337,Iowa,2013-14,33,20,13,0.606,6693,919,1984,0.463,728,1438,0.506,191,546,0.35,660,898,0.735,2689,2013,14
338,Maryland,2012-13,38,25,13,0.658,7625,986,2124,0.464,767,1478,0.519,219,646,0.339,497,732,0.679,2688,2012,13
339,NW St.,2014-15,32,19,13,0.594,6400,946,2052,0.461,682,1312,0.52,264,740,0.357,531,709,0.749,2687,2014,15
340,Toledo,2017-18,34,23,11,0.676,6800,913,1953,0.467,586,1138,0.515,327,815,0.401,534,725,0.737,2687,2017,18
341,NW St.,2013-14,31,17,14,0.548,6300,958,2037,0.47,782,1510,0.518,176,527,0.334,594,802,0.741,2686,2013,14
342,Omaha,2016-17,32,18,14,0.563,6476,895,1972,0.454,598,1207,0.495,297,765,0.388,598,799,0.748,2685,2016,17
343,Houston,2017-18,35,27,8,0.771,7000,952,2066,0.461,655,1298,0.505,297,768,0.387,484,674,0.718,2685,2017,18
344,San Francisco,2017-18,39,22,17,0.564,7850,952,2256,0.422,619,1270,0.487,333,986,0.338,448,663,0.676,2685,2017,18
345,Creighton,2010-11,39,23,16,0.59,7824,935,2034,0.46,655,1275,0.514,280,759,0.369,534,732,0.73,2684,2010,11
346,Gonzaga,2010-11,35,25,10,0.714,7050,932,1947,0.479,729,1399,0.521,203,548,0.37,617,810,0.762,2684,2010,11
347,Saint Mary's,2010-11,34,25,9,0.735,6825,946,1951,0.485,655,1205,0.544,291,746,0.39,501,660,0.759,2684,2010,11
348,Howard,2018-19,34,17,17,0.5,6845,937,2163,0.433,693,1494,0.464,244,669,0.365,566,780,0.726,2684,2018,19
349,S Dakota St.,2016-17,35,18,17,0.514,7075,881,1938,0.455,563,1055,0.534,318,883,0.36,603,782,0.771,2683,2016,17
350,Akron,2015-16,35,26,9,0.743,7025,911,2111,0.432,502,1042,0.482,409,1069,0.383,451,659,0.684,2682,2015,16
351,NC State,2017-18,33,21,12,0.636,6625,965,2054,0.47,702,1347,0.521,263,707,0.372,489,703,0.696,2682,2017,18
352,Memphis,2012-13,36,31,5,0.861,7251,976,2071,0.471,756,1479,0.511,220,592,0.372,509,771,0.66,2681,2012,13
353,Hofstra,2015-16,34,24,10,0.706,6950,914,2050,0.446,625,1238,0.505,289,812,0.356,564,818,0.689,2681,2015,16
354,Creighton,2012-13,36,28,8,0.778,7199,942,1882,0.501,635,1140,0.557,307,742,0.414,489,644,0.759,2680,2012,13
355,East Carolina,2012-13,35,23,12,0.657,7075,922,2039,0.452,648,1255,0.516,274,784,0.349,561,784,0.716,2679,2012,13
356,UCLA,2017-18,33,21,12,0.636,6750,927,2014,0.46,617,1201,0.514,310,813,0.381,515,715,0.72,2679,2017,18
357,New Mexico St.,2016-17,34,28,6,0.824,6825,913,1957,0.467,661,1210,0.546,252,747,0.337,600,843,0.712,2678,2016,17
358,Wisconsin,2016-17,37,27,10,0.73,7500,971,2135,0.455,688,1347,0.511,283,788,0.359,453,703,0.644,2678,2016,17
359,LIU,2012-13,34,20,14,0.588,6851,915,1909,0.479,669,1262,0.53,246,647,0.38,601,870,0.691,2677,2012,13
360,Eastern Ky.,2013-14,34,24,10,0.706,6824,881,1810,0.487,566,1003,0.564,315,807,0.39,600,798,0.752,2677,2013,14
361,Florida,2015-16,36,21,15,0.583,7225,930,2186,0.425,672,1376,0.488,258,810,0.319,559,863,0.648,2677,2015,16
362,Ball State,2016-17,34,21,13,0.618,6899,929,2014,0.461,610,1173,0.52,319,841,0.379,500,696,0.718,2677,2016,17
363,Stanford,2014-15,37,24,13,0.649,7525,908,2089,0.435,662,1438,0.46,246,651,0.378,614,846,0.726,2676,2014,15
364,Toledo,2016-17,34,17,17,0.5,7050,944,1966,0.48,682,1242,0.549,262,724,0.362,525,755,0.695,2675,2016,17
365,UC-Irvine,2018-19,37,31,6,0.838,7495,987,2159,0.457,735,1458,0.504,252,701,0.359,449,640,0.702,2675,2018,19
366,Cincinnati,2016-17,36,30,6,0.833,7250,969,2116,0.458,705,1352,0.521,264,764,0.346,472,688,0.686,2674,2016,17
367,Cincinnati,2017-18,36,31,5,0.861,7200,944,2100,0.45,682,1358,0.502,262,742,0.353,523,756,0.692,2673,2017,18
368,Boston College,2017-18,35,19,16,0.543,7075,948,2105,0.45,650,1274,0.51,298,831,0.359,479,646,0.741,2673,2017,18
369,Tennessee,2013-14,37,24,13,0.649,7450,927,2048,0.453,722,1417,0.51,205,631,0.325,613,852,0.719,2672,2013,14
370,Stephen F. Austin,2014-15,34,29,5,0.853,6824,911,1870,0.487,649,1178,0.551,262,692,0.379,588,799,0.736,2672,2014,15
371,UNLV,2011-12,35,26,9,0.743,7125,942,2062,0.457,651,1263,0.515,291,799,0.364,496,734,0.676,2671,2011,12
372,Dayton,2013-14,37,26,11,0.703,7450,935,2018,0.463,692,1374,0.504,243,644,0.377,558,819,0.681,2671,2013,14
373,Columbia,2015-16,35,25,10,0.714,7075,899,1986,0.453,563,1093,0.515,336,893,0.376,536,745,0.719,2670,2015,16
374,Hofstra,2014-15,34,20,14,0.588,6850,902,2013,0.448,599,1176,0.509,303,837,0.362,561,801,0.7,2668,2014,15
375,North Florida,2017-18,33,14,19,0.424,6625,939,2058,0.456,582,1113,0.523,357,945,0.378,433,570,0.76,2668,2017,18
376,Bowling Green,2018-19,34,22,12,0.647,6842,945,2134,0.443,673,1372,0.491,272,762,0.357,506,755,0.67,2668,2018,19
377,Florida,2010-11,37,29,8,0.784,7575,968,2083,0.465,735,1422,0.517,233,661,0.352,498,744,0.669,2667,2010,11
378,Bucknell,2016-17,35,26,9,0.743,7000,942,1961,0.48,656,1207,0.543,286,754,0.379,497,730,0.681,2667,2016,17
379,Iowa,2012-13,38,25,13,0.658,7675,903,2156,0.419,699,1488,0.47,204,668,0.305,655,896,0.731,2665,2012,13
380,Canisius,2016-17,34,18,16,0.529,6850,943,2066,0.456,634,1234,0.514,309,832,0.371,470,639,0.736,2665,2016,17
381,Montana,2018-19,35,26,9,0.743,7025,975,1983,0.492,688,1220,0.564,287,763,0.376,428,621,0.689,2665,2018,19
382,Weber State,2015-16,35,26,9,0.743,7100,908,1885,0.482,617,1100,0.561,291,785,0.371,555,821,0.676,2662,2015,16
383,Stephen F. Austin,2013-14,35,32,3,0.914,7050,922,1992,0.463,674,1274,0.529,248,718,0.345,569,800,0.711,2661,2013,14
384,Canisius,2013-14,34,21,13,0.618,6949,913,1989,0.459,642,1287,0.499,271,702,0.386,564,762,0.74,2661,2013,14
385,Oregon,2018-19,38,25,13,0.658,7649,958,2126,0.451,663,1286,0.516,295,840,0.351,450,624,0.721,2661,2018,19
386,San Diego State,2010-11,37,34,3,0.919,7450,991,2141,0.463,768,1502,0.511,223,639,0.349,455,653,0.697,2660,2010,11
387,Siena,2015-16,34,21,13,0.618,6925,929,1992,0.466,714,1407,0.507,215,585,0.368,586,812,0.722,2659,2015,16
388,Northern Ky.,2016-17,35,24,11,0.686,7000,928,2037,0.456,628,1178,0.533,300,859,0.349,503,740,0.68,2659,2016,17
389,Stanford,2011-12,37,26,11,0.703,7525,938,2107,0.445,686,1442,0.476,252,665,0.379,529,794,0.666,2657,2011,12
390,Utah Valley,2017-18,34,23,11,0.676,6825,926,1919,0.483,659,1227,0.537,267,692,0.386,538,725,0.742,2657,2017,18
391,Michigan,2015-16,36,23,13,0.639,7225,947,2048,0.462,605,1147,0.527,342,901,0.38,420,569,0.738,2656,2015,16
392,Stanford,2017-18,35,19,16,0.543,7050,925,2007,0.461,692,1375,0.503,233,632,0.369,572,835,0.685,2655,2017,18
393,West Virginia,2018-19,36,15,21,0.417,7300,901,2181,0.413,632,1329,0.476,269,852,0.316,584,849,0.688,2655,2018,19
394,SE Missouri St,2013-14,32,18,14,0.563,6486,961,1924,0.499,743,1317,0.564,218,607,0.359,514,743,0.692,2654,2013,14
395,Villanova,2018-19,36,26,10,0.722,7270,884,2019,0.438,504,938,0.537,380,1081,0.352,506,695,0.728,2654,2018,19
396,Liberty,2018-19,36,29,7,0.806,7200,963,1977,0.487,641,1104,0.581,322,873,0.369,406,524,0.775,2654,2018,19
397,Campbell,2016-17,37,19,18,0.514,7450,909,1992,0.456,615,1194,0.515,294,798,0.368,541,720,0.751,2653,2016,17
398,Chattanooga,2015-16,35,29,6,0.829,7050,897,1963,0.457,635,1234,0.515,262,729,0.359,596,811,0.735,2652,2015,16
399,Florida State,2015-16,34,20,14,0.588,6825,948,2042,0.464,728,1397,0.521,220,645,0.341,536,771,0.695,2652,2015,16
400,Norfolk State,2018-19,36,22,14,0.611,7295,900,2079,0.433,618,1309,0.472,282,770,0.366,570,803,0.71,2652,2018,19
,,,,,,,,School,School,School,School,School,School,School,School,School,School,School,School,School,,
,Schl,Season,G,W,L,W-L%,MP,FG,FGA,FG%,2P,2PA,2P%,3P,3PA,3P%,FT,FTA,FT%,PTS,Season,
401,Michigan State,2011-12,37,29,8,0.784,7425,960,2012,0.477,760,1457,0.522,200,555,0.36,531,759,0.7,2651,2011,12
402,Villanova,2013-14,34,29,5,0.853,6925,870,1907,0.456,566,1052,0.538,304,855,0.356,607,848,0.716,2651,2013,14
403,North Florida,2014-15,35,23,12,0.657,7000,897,1910,0.47,580,1100,0.527,317,810,0.391,540,747,0.723,2651,2014,15
404,Oregon,2012-13,37,28,9,0.757,7526,944,2110,0.447,752,1533,0.491,192,577,0.333,570,809,0.705,2650,2012,13
405,Lehigh,2011-12,35,27,8,0.771,7050,902,2030,0.444,648,1304,0.497,254,726,0.35,590,768,0.768,2648,2011,12
406,Colgate,2018-19,35,24,11,0.686,7075,955,1995,0.479,635,1180,0.538,320,815,0.393,418,563,0.742,2648,2018,19
407,Colorado,2018-19,36,23,13,0.639,7226,924,2036,0.454,694,1325,0.524,230,711,0.323,570,757,0.753,2648,2018,19
408,Sam Houston St.,2013-14,35,24,11,0.686,7101,875,1893,0.462,625,1255,0.498,250,638,0.392,647,969,0.668,2647,2013,14
409,Murray State,2013-14,34,23,11,0.676,6848,901,1898,0.475,649,1227,0.529,252,671,0.376,593,883,0.672,2647,2013,14
410,Ohio,2013-14,37,25,12,0.676,7525,937,2041,0.459,663,1265,0.524,274,776,0.353,499,699,0.714,2647,2013,14
411,Washington,2011-12,35,24,11,0.686,7050,966,2157,0.448,749,1524,0.491,217,633,0.343,497,798,0.623,2646,2011,12
412,Iowa State,2014-15,34,25,9,0.735,6800,940,1973,0.476,677,1247,0.543,263,726,0.362,502,721,0.696,2645,2014,15
413,Portland State,2016-17,31,15,16,0.484,6400,959,1991,0.482,721,1294,0.557,238,697,0.341,489,743,0.658,2645,2016,17
414,Arizona State,2017-18,32,20,12,0.625,6431,888,1920,0.463,600,1127,0.532,288,793,0.363,581,793,0.733,2645,2017,18
415,Florida,2012-13,37,29,8,0.784,7400,960,2010,0.478,660,1216,0.543,300,794,0.378,422,623,0.677,2642,2012,13
416,Georgia State,2013-14,34,25,9,0.735,6899,900,1923,0.468,648,1251,0.518,252,672,0.375,589,757,0.778,2641,2013,14
417,Nicholls State,2017-18,32,21,11,0.656,6399,941,1994,0.472,681,1265,0.538,260,729,0.357,499,696,0.717,2641,2017,18
418,Coastal Caro.,2018-19,34,17,17,0.5,6851,899,1986,0.453,615,1220,0.504,284,766,0.371,559,778,0.719,2641,2018,19
419,Texas-Arlington,2017-18,34,21,13,0.618,6825,927,2054,0.451,633,1236,0.512,294,818,0.359,492,713,0.69,2640,2017,18
420,South Dakota,2016-17,34,22,12,0.647,6825,907,2044,0.444,683,1387,0.492,224,657,0.341,601,852,0.705,2639,2016,17
421,Murray State,2016-17,33,16,17,0.485,6750,899,2040,0.441,610,1237,0.493,289,803,0.36,552,751,0.735,2639,2016,17
422,Citadel,2017-18,32,11,21,0.344,6450,889,2148,0.414,503,1015,0.496,386,1133,0.341,475,673,0.706,2639,2017,18
423,Marquette,2011-12,35,27,8,0.771,7000,919,2033,0.452,718,1437,0.5,201,596,0.337,599,831,0.721,2638,2011,12
424,Belmont,2015-16,32,20,12,0.625,6425,914,1849,0.494,576,918,0.627,338,931,0.363,472,650,0.726,2638,2015,16
425,Butler,2015-16,33,22,11,0.667,6625,918,1969,0.466,682,1368,0.499,236,601,0.393,566,774,0.731,2638,2015,16
426,Arizona State,2018-19,34,23,11,0.676,6900,899,2012,0.447,659,1298,0.508,240,714,0.336,600,882,0.68,2638,2018,19
427,North Florida,2016-17,34,15,19,0.441,6800,926,2025,0.457,631,1184,0.533,295,841,0.351,490,748,0.655,2637,2016,17
428,William & Mary,2017-18,31,19,12,0.613,6275,910,1782,0.511,573,1005,0.57,337,777,0.434,479,591,0.81,2636,2017,18
429,Siena,2013-14,38,20,18,0.526,7699,908,2165,0.419,739,1649,0.448,169,516,0.328,650,903,0.72,2635,2013,14
430,Ohio State,2014-15,35,24,11,0.686,7050,964,1995,0.483,728,1358,0.536,236,637,0.37,471,693,0.68,2635,2014,15
431,Georgia Tech,2015-16,36,21,15,0.583,7225,965,2150,0.449,752,1553,0.484,213,597,0.357,492,681,0.722,2635,2015,16
432,Virginia Tech,2017-18,33,21,12,0.636,6676,931,1865,0.499,642,1120,0.573,289,745,0.388,483,681,0.709,2634,2017,18
433,Tx-Rio Grande,2018-19,37,20,17,0.541,7450,895,2139,0.418,692,1503,0.46,203,636,0.319,641,923,0.694,2634,2018,19
434,Towson,2013-14,36,25,11,0.694,7224,867,1910,0.454,654,1314,0.498,213,596,0.357,686,998,0.687,2633,2013,14
435,Indiana,2014-15,34,20,14,0.588,6825,923,1989,0.464,604,1203,0.502,319,786,0.406,468,651,0.719,2633,2014,15
436,Miami (FL),2015-16,35,27,8,0.771,7026,907,1895,0.479,666,1252,0.532,241,643,0.375,578,772,0.749,2633,2015,16
437,Wyoming,2017-18,33,20,13,0.606,6824,873,1959,0.446,569,1078,0.528,304,881,0.345,583,790,0.738,2633,2017,18
438,South Dakota,2010-11,33,18,15,0.545,6698,939,2063,0.455,687,1340,0.513,252,723,0.349,502,752,0.668,2632,2010,11
439,Louisiana Tech,2014-15,36,27,9,0.75,7253,945,2112,0.447,697,1356,0.514,248,756,0.328,494,716,0.69,2632,2014,15
440,VMI,2011-12,33,17,16,0.515,6625,892,2006,0.445,609,1118,0.545,283,888,0.319,564,784,0.719,2631,2011,12
441,UConn,2015-16,36,25,11,0.694,7302,944,2078,0.454,689,1379,0.5,255,699,0.365,488,615,0.793,2631,2015,16
442,Winthrop,2015-16,32,23,9,0.719,6400,890,1869,0.476,605,1101,0.55,285,768,0.371,566,756,0.749,2631,2015,16
443,Marquette,2016-17,32,19,13,0.594,6425,919,1888,0.487,583,1105,0.528,336,783,0.429,457,585,0.781,2631,2016,17
444,Texas A&M,2017-18,35,22,13,0.629,7001,976,2121,0.46,746,1421,0.525,230,700,0.329,449,679,0.661,2631,2017,18
445,Fresno State,2015-16,35,25,10,0.714,7100,926,2126,0.436,707,1488,0.475,219,638,0.343,559,805,0.694,2630,2015,16
446,UMBC,2017-18,36,25,11,0.694,7200,926,2088,0.443,562,1148,0.49,364,940,0.387,414,641,0.646,2630,2017,18
447,Iowa,2017-18,33,14,19,0.424,6650,946,1975,0.479,694,1303,0.533,252,672,0.375,486,699,0.695,2630,2017,18
448,Kansas State,2017-18,37,25,12,0.676,7425,937,2025,0.463,683,1280,0.534,254,745,0.341,502,684,0.734,2630,2017,18
449,NJIT,2015-16,35,20,15,0.571,7051,911,2045,0.445,605,1180,0.513,306,865,0.354,501,679,0.738,2629,2015,16
450,Marquette,2018-19,34,24,10,0.706,6870,893,1969,0.454,574,1147,0.5,319,822,0.388,524,692,0.757,2629,2018,19
451,Duke,2011-12,34,27,7,0.794,6850,874,1915,0.456,600,1176,0.51,274,739,0.371,606,864,0.701,2628,2011,12
452,Iona,2015-16,33,22,11,0.667,6625,919,2011,0.457,592,1127,0.525,327,884,0.37,463,651,0.711,2628,2015,16
453,Louisville,2016-17,34,25,9,0.735,6850,952,2085,0.457,714,1415,0.505,238,670,0.355,486,708,0.686,2628,2016,17
454,UNC Greensboro,2016-17,35,25,10,0.714,6999,947,2043,0.464,639,1236,0.517,308,807,0.382,426,603,0.706,2628,2016,17
455,Texas,2018-19,37,21,16,0.568,7475,929,2146,0.433,604,1212,0.498,325,934,0.348,445,637,0.699,2628,2018,19
456,Miss. St.,2018-19,34,23,11,0.676,6850,936,1982,0.472,644,1208,0.533,292,774,0.377,464,647,0.717,2628,2018,19
457,SMU,2013-14,37,27,10,0.73,7400,937,1938,0.483,763,1479,0.516,174,459,0.379,579,848,0.683,2627,2013,14
458,Prairie View,2018-19,35,22,13,0.629,7000,903,2061,0.438,678,1358,0.499,225,703,0.32,596,875,0.681,2627,2018,19
459,Kent State,2010-11,37,25,12,0.676,7500,960,2178,0.441,758,1575,0.481,202,603,0.335,504,754,0.668,2626,2010,11
460,Virginia,2015-16,37,29,8,0.784,7425,964,1964,0.491,740,1407,0.526,224,557,0.402,474,630,0.752,2626,2015,16
461,Montana,2017-18,34,26,8,0.765,6900,944,2021,0.467,758,1472,0.515,186,549,0.339,551,780,0.706,2625,2017,18
462,Georgetown,2018-19,33,19,14,0.576,6775,894,2017,0.443,625,1260,0.496,269,757,0.355,568,771,0.737,2625,2018,19
463,VCU,2013-14,35,26,9,0.743,7100,922,2196,0.42,662,1452,0.456,260,744,0.349,520,772,0.674,2624,2013,14
464,Louisiana Tech,2015-16,33,23,10,0.697,6725,915,1999,0.458,681,1295,0.526,234,704,0.332,560,842,0.665,2624,2015,16
465,Virginia Tech,2015-16,35,20,15,0.571,7125,876,1953,0.449,676,1378,0.491,200,575,0.348,672,964,0.697,2624,2015,16
466,Louisville,2010-11,35,25,10,0.714,7125,949,2097,0.453,640,1243,0.515,309,854,0.362,416,627,0.663,2623,2010,11
467,Lamar,2016-17,34,19,15,0.559,6875,907,1977,0.459,642,1245,0.516,265,732,0.362,544,813,0.669,2623,2016,17
468,N.C. A&T,2017-18,35,20,15,0.571,7075,929,2010,0.462,716,1303,0.55,213,707,0.301,552,776,0.711,2623,2017,18
469,St. John's (NY),2018-19,34,21,13,0.618,6876,944,2100,0.45,655,1291,0.507,289,809,0.357,446,620,0.719,2623,2018,19
470,Baylor,2015-16,34,22,12,0.647,6876,933,2003,0.466,723,1431,0.505,210,572,0.367,545,752,0.725,2621,2015,16
471,Liberty,2017-18,37,22,15,0.595,7550,899,1948,0.461,599,1143,0.524,300,805,0.373,523,660,0.792,2621,2017,18
472,Bethune-Cookman,2017-18,32,18,14,0.563,6450,903,2039,0.443,662,1280,0.517,241,759,0.318,575,820,0.701,2621,2017,18
473,Hawaii,2015-16,34,28,6,0.824,6825,893,1946,0.459,656,1209,0.543,237,737,0.322,597,873,0.684,2620,2015,16
474,UNC Wilmington,2015-16,33,25,8,0.758,6675,928,2039,0.455,698,1362,0.512,230,677,0.34,534,760,0.703,2620,2015,16
475,Western Ky.,2015-16,34,18,16,0.529,6925,925,1970,0.47,692,1327,0.521,233,643,0.362,537,768,0.699,2620,2015,16
476,Rider,2017-18,32,22,10,0.688,6425,932,2004,0.465,689,1326,0.52,243,678,0.358,513,844,0.608,2620,2017,18
477,St. Bonaventure,2017-18,34,26,8,0.765,6898,884,1959,0.451,629,1298,0.485,255,661,0.386,597,794,0.752,2620,2017,18
478,Fairl. Dickinson,2018-19,35,21,14,0.6,7100,921,1939,0.475,652,1267,0.515,269,672,0.4,509,702,0.725,2620,2018,19
479,Gardner-Webb,2014-15,35,20,15,0.571,7101,909,2028,0.448,621,1205,0.515,288,823,0.35,513,767,0.669,2619,2014,15
480,Eastern Wash.,2017-18,35,20,15,0.571,7050,936,2017,0.464,626,1189,0.526,310,828,0.374,437,572,0.764,2619,2017,18
481,Furman,2017-18,33,23,10,0.697,6625,942,2006,0.47,604,1056,0.572,338,950,0.356,397,557,0.713,2619,2017,18
482,Milwaukee,2015-16,33,20,13,0.606,6725,879,1927,0.456,573,1085,0.528,306,842,0.363,554,718,0.772,2618,2015,16
483,Weber State,2018-19,33,18,15,0.545,6650,920,1934,0.476,671,1250,0.537,249,684,0.364,528,708,0.746,2617,2018,19
484,Stanford,2013-14,36,23,13,0.639,7226,896,1950,0.459,688,1379,0.499,208,571,0.364,616,877,0.702,2616,2013,14
485,VCU,2016-17,35,26,9,0.743,7100,945,2050,0.461,746,1448,0.515,199,602,0.331,527,747,0.705,2616,2016,17
486,Youngstown St.,2016-17,34,13,21,0.382,6950,981,2230,0.44,731,1480,0.494,250,750,0.333,404,601,0.672,2616,2016,17
487,Oral Roberts,2010-11,35,19,16,0.543,7050,925,1950,0.474,732,1422,0.515,193,528,0.366,572,798,0.717,2615,2010,11
488,Vanderbilt,2011-12,36,25,11,0.694,7275,885,1921,0.461,578,1129,0.512,307,792,0.388,538,770,0.699,2615,2011,12
489,Utah Valley,2016-17,34,17,17,0.5,6925,886,2028,0.437,586,1091,0.537,300,937,0.32,543,767,0.708,2615,2016,17
490,Winthrop,2016-17,33,26,7,0.788,6750,891,1957,0.455,578,1118,0.517,313,839,0.373,520,725,0.717,2615,2016,17
491,Memphis,2011-12,35,26,9,0.743,7075,933,1899,0.491,748,1388,0.539,185,511,0.362,563,785,0.717,2614,2011,12
492,Memphis,2013-14,34,24,10,0.706,6850,958,2009,0.477,776,1457,0.533,182,552,0.33,516,801,0.644,2614,2013,14
493,Georgia State,2017-18,35,24,11,0.686,7075,937,2033,0.461,614,1194,0.514,323,839,0.385,417,615,0.678,2614,2017,18
494,CS Long Beach,2015-16,35,20,15,0.571,7075,896,2077,0.431,609,1294,0.471,287,783,0.367,534,776,0.688,2613,2015,16
495,Louisiana,2018-19,32,19,13,0.594,6450,901,2026,0.445,618,1205,0.513,283,821,0.345,527,710,0.742,2612,2018,19
496,Colorado State,2016-17,36,24,12,0.667,7200,879,2070,0.425,622,1312,0.474,257,758,0.339,596,815,0.731,2611,2016,17
497,Saint Mary's,2012-13,35,28,7,0.8,7026,910,1939,0.469,637,1211,0.526,273,728,0.375,517,713,0.725,2610,2012,13
498,Virginia Tech,2016-17,33,22,11,0.667,6650,887,1813,0.489,597,1093,0.546,290,720,0.403,546,741,0.737,2610,2016,17
499,VCU,2014-15,36,26,10,0.722,7375,896,2139,0.419,603,1285,0.469,293,854,0.343,524,797,0.657,2609,2014,15
500,Wichita State,2018-19,37,22,15,0.595,7425,929,2277,0.408,653,1387,0.471,276,890,0.31,475,655,0.725,2609,2018,19
,,,,,,,,School,School,School,School,School,School,School,School,School,School,School,School,School,,
,Schl,Season,G,W,L,W-L%,MP,FG,FGA,FG%,2P,2PA,2P%,3P,3PA,3P%,FT,FTA,FT%,PTS,Season,
501,Davidson,2015-16,33,20,13,0.606,6625,894,2022,0.442,577,1130,0.511,317,892,0.355,503,661,0.761,2608,2015,16
502,Northern Ariz.,2014-15,38,23,15,0.605,7677,878,2175,0.404,623,1441,0.432,255,734,0.347,595,793,0.75,2606,2014,15
503,UAB,2015-16,33,26,7,0.788,6700,942,1970,0.478,692,1299,0.533,250,671,0.373,472,654,0.722,2606,2015,16
504,San Diego State,2015-16,38,28,10,0.737,7650,885,2100,0.421,663,1413,0.469,222,687,0.323,613,892,0.687,2605,2015,16
505,Ohio,2010-11,35,19,16,0.543,7275,896,2060,0.435,636,1326,0.48,260,734,0.354,552,769,0.718,2604,2010,11
506,UCLA,2012-13,35,25,10,0.714,7100,961,2131,0.451,790,1617,0.489,171,514,0.333,511,706,0.724,2604,2012,13
507,UNC,2013-14,34,24,10,0.706,6851,953,2057,0.463,807,1623,0.497,146,434,0.336,552,882,0.626,2604,2013,14
508,Houston Baptist,2015-16,34,17,17,0.5,6800,899,1903,0.472,695,1342,0.518,204,561,0.364,602,839,0.718,2604,2015,16
509,Old Dominion,2015-16,38,25,13,0.658,7650,987,2227,0.443,828,1699,0.487,159,528,0.301,471,691,0.682,2604,2015,16
510,Alabama,2017-18,36,20,16,0.556,7177,910,1975,0.461,681,1273,0.535,229,702,0.326,555,828,0.67,2604,2017,18
511,Morehead State,2013-14,34,20,14,0.588,6925,861,1927,0.447,673,1298,0.518,188,629,0.299,693,992,0.699,2603,2013,14
512,Memphis,2015-16,34,19,15,0.559,6850,877,2124,0.413,671,1489,0.451,206,635,0.324,643,890,0.722,2603,2015,16
513,LSU,2015-16,33,19,14,0.576,6650,915,1990,0.46,712,1370,0.52,203,620,0.327,569,856,0.665,2602,2015,16
514,Cal St Northridge,2018-19,34,13,21,0.382,6875,968,2103,0.46,734,1455,0.504,234,648,0.361,431,676,0.638,2601,2018,19
515,BYU,2017-18,35,24,11,0.686,7075,919,1905,0.482,694,1256,0.553,225,649,0.347,537,716,0.75,2600,2017,18
516,Ohio State,2012-13,37,29,8,0.784,7426,928,2057,0.451,701,1419,0.494,227,638,0.356,516,729,0.708,2599,2012,13
517,SMU,2016-17,35,30,5,0.857,7000,914,1934,0.473,628,1229,0.511,286,705,0.406,485,696,0.697,2599,2016,17
518,Texas,2013-14,35,24,11,0.686,7025,905,2095,0.432,727,1550,0.469,178,545,0.327,610,909,0.671,2598,2013,14
519,Georgia State,2018-19,34,24,10,0.706,6800,903,1968,0.459,573,1109,0.517,330,859,0.384,462,694,0.666,2598,2018,19
520,Coastal Caro.,2010-11,34,28,6,0.824,6875,930,1915,0.486,769,1431,0.537,161,484,0.333,576,832,0.692,2597,2010,11
521,Detroit,2011-12,36,22,14,0.611,7225,903,2008,0.45,738,1455,0.507,165,553,0.298,626,857,0.73,2597,2011,12
522,Ohio,2011-12,37,29,8,0.784,7450,901,2107,0.428,623,1298,0.48,278,809,0.344,517,749,0.69,2597,2011,12
523,Lamar,2018-19,33,20,13,0.606,6700,902,1976,0.456,674,1312,0.514,228,664,0.343,565,823,0.687,2597,2018,19
524,Southern Miss,2013-14,36,29,7,0.806,7225,873,1884,0.463,672,1308,0.514,201,576,0.349,649,956,0.679,2596,2013,14
525,Richmond,2016-17,35,22,13,0.629,7029,938,1993,0.471,667,1200,0.556,271,793,0.342,449,630,0.713,2596,2016,17
526,Detroit,2015-16,31,16,15,0.516,6225,898,1929,0.466,654,1278,0.512,244,651,0.375,555,795,0.698,2595,2015,16
527,Butler,2016-17,34,25,9,0.735,6850,906,1898,0.477,645,1184,0.545,261,714,0.366,522,704,0.741,2595,2016,17
528,Boise State,2010-11,35,22,13,0.629,7150,876,2002,0.438,639,1313,0.487,237,689,0.344,605,838,0.722,2594,2010,11
529,Syracuse,2016-17,34,19,15,0.559,6850,894,1950,0.458,594,1159,0.513,300,791,0.379,506,685,0.739,2594,2016,17
530,Robert Morris,2013-14,36,22,14,0.611,7224,890,2033,0.438,619,1330,0.465,271,703,0.385,542,745,0.728,2593,2013,14
531,Arizona State,2016-17,33,15,18,0.455,6625,888,2047,0.434,560,1151,0.487,328,896,0.366,489,653,0.749,2593,2016,17
532,Wofford,2016-17,33,16,17,0.485,6750,900,1926,0.467,589,1155,0.51,311,771,0.403,482,619,0.779,2593,2016,17
533,Texas Southern,2016-17,35,23,12,0.657,7050,866,2015,0.43,661,1322,0.5,205,693,0.296,656,893,0.735,2593,2016,17
534,Miami (FL),2014-15,38,25,13,0.658,7725,878,2053,0.428,586,1237,0.474,292,816,0.358,544,729,0.746,2592,2014,15
535,Sam Houston St.,2014-15,35,26,9,0.743,7075,846,1973,0.429,580,1165,0.498,266,808,0.329,634,898,0.706,2592,2014,15
536,Boise State,2013-14,34,21,13,0.618,6901,890,1952,0.456,626,1242,0.504,264,710,0.372,547,730,0.749,2591,2013,14
537,Davidson,2013-14,33,20,13,0.606,6700,896,1877,0.477,623,1151,0.541,273,726,0.376,526,735,0.716,2591,2013,14
538,S Dakota St.,2015-16,34,26,8,0.765,6800,877,1950,0.45,622,1235,0.504,255,715,0.357,582,783,0.743,2591,2015,16
539,Ohio State,2017-18,34,25,9,0.735,6875,951,1980,0.48,712,1302,0.547,239,678,0.353,450,616,0.731,2591,2017,18
540,San Diego,2018-19,36,21,15,0.583,7300,914,2002,0.457,630,1194,0.528,284,808,0.351,479,641,0.747,2591,2018,19
541,UCLA,2014-15,36,22,14,0.611,7250,930,2099,0.443,707,1493,0.474,223,606,0.368,507,750,0.676,2590,2014,15
542,Lipscomb,2015-16,33,12,21,0.364,6700,888,2017,0.44,557,1096,0.508,331,921,0.359,483,695,0.695,2590,2015,16
543,Furman,2016-17,35,23,12,0.657,7050,918,1941,0.473,599,1113,0.538,319,828,0.385,435,624,0.697,2590,2016,17
544,Mercer,2011-12,38,27,11,0.711,7650,899,1968,0.457,635,1238,0.513,264,730,0.362,527,734,0.718,2589,2011,12
545,Syracuse,2015-16,37,23,14,0.622,7475,884,2080,0.425,569,1204,0.473,315,876,0.36,506,736,0.688,2589,2015,16
546,Seattle,2017-18,34,20,14,0.588,6875,881,1975,0.446,569,1131,0.503,312,844,0.37,515,698,0.738,2589,2017,18
547,Missouri,2012-13,34,23,11,0.676,6850,924,2015,0.459,709,1380,0.514,215,635,0.339,525,706,0.744,2588,2012,13
548,George Mason,2012-13,38,22,16,0.579,7676,922,2112,0.437,719,1525,0.471,203,587,0.346,540,745,0.725,2587,2012,13
549,Jacksonville St.,2017-18,36,23,13,0.639,7250,954,2091,0.456,743,1441,0.516,211,650,0.325,468,657,0.712,2587,2017,18
550,Vermont,2017-18,35,27,8,0.771,7000,879,1803,0.488,619,1154,0.536,260,649,0.401,569,755,0.754,2587,2017,18
551,Eastern Ky.,2012-13,35,25,10,0.714,7050,888,1903,0.467,581,1038,0.56,307,865,0.355,503,644,0.781,2586,2012,13
552,Pitt,2013-14,36,26,10,0.722,7332,895,1944,0.46,712,1422,0.501,183,522,0.351,613,861,0.712,2586,2013,14
553,Nebraska,2018-19,36,19,17,0.528,7225,916,2133,0.429,646,1333,0.485,270,800,0.338,484,694,0.697,2586,2018,19
554,Texas Southern,2013-14,34,19,15,0.559,6900,857,1854,0.462,640,1251,0.512,217,603,0.36,653,910,0.718,2584,2013,14
555,Charlotte,2015-16,33,14,19,0.424,6700,920,2066,0.445,654,1370,0.477,266,696,0.382,478,685,0.698,2584,2015,16
556,Clemson,2017-18,35,25,10,0.714,7051,899,1971,0.456,611,1185,0.516,288,786,0.366,498,660,0.755,2584,2017,18
557,Tennessee,2017-18,35,26,9,0.743,7048,885,2012,0.44,612,1294,0.473,273,718,0.38,541,715,0.757,2584,2017,18
558,South Carolina,2015-16,34,25,9,0.735,6847,882,2040,0.432,666,1426,0.467,216,614,0.352,603,883,0.683,2583,2015,16
559,Rhode Island,2017-18,34,26,8,0.765,6849,954,2096,0.455,718,1426,0.504,236,670,0.352,439,630,0.697,2583,2017,18
560,Samford,2018-19,33,17,16,0.515,6775,921,1951,0.472,667,1264,0.528,254,687,0.37,487,666,0.731,2583,2018,19
561,Vanderbilt,2010-11,34,23,11,0.676,6875,848,1853,0.458,585,1145,0.511,263,708,0.371,622,837,0.743,2581,2010,11
562,Grand Canyon,2015-16,34,27,7,0.794,6825,896,1978,0.453,686,1395,0.492,210,583,0.36,579,835,0.693,2581,2015,16
563,UNLV,2015-16,33,18,15,0.545,6750,887,2015,0.44,635,1255,0.506,252,760,0.332,555,815,0.681,2581,2015,16
564,Campbell,2017-18,34,18,16,0.529,6850,891,1867,0.477,578,1061,0.545,313,806,0.388,486,648,0.75,2581,2017,18
565,Oakland,2017-18,33,19,14,0.576,6650,884,1966,0.45,609,1184,0.514,275,782,0.352,537,697,0.77,2580,2017,18
566,UCLA,2018-19,33,17,16,0.515,6675,919,2012,0.457,663,1291,0.514,256,721,0.355,486,768,0.633,2580,2018,19
567,Miami (FL),2010-11,36,21,15,0.583,7250,872,1955,0.446,589,1205,0.489,283,750,0.377,552,761,0.725,2579,2010,11
568,USC Upstate,2014-15,36,24,12,0.667,7200,938,2124,0.442,648,1261,0.514,290,863,0.336,413,631,0.655,2579,2014,15
569,Houston,2012-13,33,20,13,0.606,6781,912,1965,0.464,713,1414,0.504,199,551,0.361,555,782,0.71,2578,2012,13
570,North Dakota,2016-17,32,22,10,0.688,6500,926,1919,0.483,698,1334,0.523,228,585,0.39,498,698,0.713,2578,2016,17
571,Wofford,2017-18,34,21,13,0.618,6799,901,1906,0.473,544,1041,0.523,357,865,0.413,419,538,0.779,2578,2017,18
572,Richmond,2010-11,37,29,8,0.784,7450,922,2007,0.459,635,1272,0.499,287,735,0.39,446,649,0.687,2577,2010,11
573,Providence,2015-16,35,24,11,0.686,7075,881,2093,0.421,632,1317,0.48,249,776,0.321,566,781,0.725,2577,2015,16
574,Rhode Island,2016-17,35,25,10,0.714,7025,916,2019,0.454,699,1366,0.512,217,653,0.332,528,791,0.668,2577,2016,17
575,St. Francis (PA),2016-17,34,17,17,0.5,6875,943,2021,0.467,666,1312,0.508,277,709,0.391,414,598,0.692,2577,2016,17
576,Florida,2017-18,34,21,13,0.618,6874,893,2065,0.432,585,1233,0.474,308,832,0.37,483,673,0.718,2577,2017,18
577,Colorado,2015-16,34,22,12,0.647,6850,865,2029,0.426,613,1382,0.444,252,647,0.389,594,808,0.735,2576,2015,16
578,Saint Mary's,2015-16,35,29,6,0.829,7000,951,1887,0.504,648,1140,0.568,303,747,0.406,371,539,0.688,2576,2015,16
579,USC Upstate,2016-17,33,17,16,0.515,6675,936,2042,0.458,652,1221,0.534,284,821,0.346,419,638,0.657,2575,2016,17
580,Providence,2017-18,35,21,14,0.6,7125,899,2037,0.441,676,1366,0.495,223,671,0.332,554,787,0.704,2575,2017,18
581,Michigan,2018-19,37,30,7,0.811,7394,941,2102,0.448,654,1263,0.518,287,839,0.342,406,579,0.701,2575,2018,19
582,Charleston So.,2018-19,34,18,16,0.529,6850,926,2156,0.429,602,1211,0.497,324,945,0.343,398,588,0.677,2574,2018,19
583,Jacksonville St.,2018-19,33,24,9,0.727,6725,953,2063,0.462,753,1429,0.527,200,634,0.315,468,630,0.743,2574,2018,19
584,Virginia Tech,2018-19,35,26,9,0.743,7050,893,1900,0.47,566,1069,0.529,327,831,0.394,461,606,0.761,2574,2018,19
585,Lamar,2011-12,35,23,12,0.657,7024,902,2087,0.432,749,1633,0.459,153,454,0.337,616,855,0.72,2573,2011,12
586,Auburn,2016-17,32,18,14,0.563,6450,861,1969,0.437,572,1180,0.485,289,789,0.366,562,836,0.672,2573,2016,17
587,Southern Utah,2018-19,34,17,17,0.5,6900,881,1997,0.441,609,1198,0.508,272,799,0.34,539,757,0.712,2573,2018,19
588,New Mexico St.,2017-18,34,28,6,0.824,6825,963,2104,0.458,705,1331,0.53,258,773,0.334,388,603,0.643,2572,2017,18
589,Pepperdine,2018-19,34,16,18,0.471,6850,865,1949,0.444,552,1130,0.488,313,819,0.382,529,696,0.76,2572,2018,19
590,Davidson,2011-12,33,25,8,0.758,6650,879,1969,0.446,624,1209,0.516,255,760,0.336,558,731,0.763,2571,2011,12
591,Vermont,2016-17,35,29,6,0.829,6999,943,1909,0.494,714,1288,0.554,229,621,0.369,456,651,0.7,2571,2016,17
592,Baylor,2017-18,34,19,15,0.559,6875,941,2007,0.469,724,1399,0.518,217,608,0.357,470,640,0.734,2571,2017,18
593,Utah,2017-18,35,23,12,0.657,7050,876,1903,0.46,554,1033,0.536,322,870,0.37,497,655,0.759,2571,2017,18
594,Sam Houston St.,2017-18,36,21,15,0.583,7225,900,2115,0.426,643,1353,0.475,257,762,0.337,514,719,0.715,2571,2017,18
595,Arizona,2012-13,35,27,8,0.771,7026,880,1933,0.455,611,1208,0.506,269,725,0.371,541,722,0.749,2570,2012,13
596,S Dakota St.,2014-15,35,24,11,0.686,7053,867,1918,0.452,587,1186,0.495,280,732,0.383,556,780,0.713,2570,2014,15
597,Minnesota,2011-12,38,23,15,0.605,7775,915,1979,0.462,712,1408,0.506,203,571,0.356,536,769,0.697,2569,2011,12
598,Syracuse,2010-11,35,27,8,0.771,7050,936,1983,0.472,714,1355,0.527,222,628,0.354,474,713,0.665,2568,2010,11
599,S Dakota St.,2012-13,35,25,10,0.714,7100,910,1938,0.47,640,1244,0.514,270,694,0.389,478,627,0.762,2568,2012,13
600,Detroit,2012-13,33,20,13,0.606,6600,908,1991,0.456,674,1306,0.516,234,685,0.342,518,711,0.729,2568,2012,13
,,,,,,,,School,School,School,School,School,School,School,School,School,School,School,School,School,,
,Schl,Season,G,W,L,W-L%,MP,FG,FGA,FG%,2P,2PA,2P%,3P,3PA,3P%,FT,FTA,FT%,PTS,Season,
601,Colorado,2016-17,34,19,15,0.559,6850,888,1993,0.446,638,1275,0.5,250,718,0.348,542,770,0.704,2568,2016,17
602,Providence,2013-14,35,23,12,0.657,7250,849,1984,0.428,631,1356,0.465,218,628,0.347,650,831,0.782,2566,2013,14
603,Eastern Mich.,2016-17,33,16,17,0.485,6649,918,2046,0.449,707,1430,0.494,211,616,0.343,519,716,0.725,2566,2016,17
604,Green Bay,2016-17,32,18,14,0.563,6475,913,2061,0.443,716,1449,0.494,197,612,0.322,542,787,0.689,2565,2016,17
605,Valparaiso,2010-11,35,23,12,0.657,7125,948,2001,0.474,728,1316,0.553,220,685,0.321,448,674,0.665,2564,2010,11
606,Northeastern,2018-19,34,23,11,0.676,6925,880,1848,0.476,552,990,0.558,328,858,0.382,476,634,0.751,2564,2018,19
607,San Francisco,2011-12,34,20,14,0.588,6847,906,1942,0.467,667,1261,0.529,239,681,0.351,512,745,0.687,2563,2011,12
608,Drake,2018-19,34,24,10,0.706,6925,908,1943,0.467,629,1170,0.538,279,773,0.361,468,618,0.757,2563,2018,19
609,New Mexico,2010-11,35,22,13,0.629,7100,877,1920,0.457,651,1266,0.514,226,654,0.346,582,817,0.712,2562,2010,11
610,UNC Greensboro,2017-18,35,27,8,0.771,7150,924,2075,0.445,593,1137,0.522,331,938,0.353,383,549,0.698,2562,2017,18
611,Belmont,2017-18,33,24,9,0.727,6600,901,1853,0.486,523,848,0.617,378,1005,0.376,382,517,0.739,2562,2017,18
612,Furman,2018-19,33,25,8,0.758,6700,930,1962,0.474,592,1027,0.576,338,935,0.361,364,508,0.717,2562,2018,19
613,Eastern Ky.,2018-19,31,13,18,0.419,6325,902,2125,0.424,630,1293,0.487,272,832,0.327,486,683,0.712,2562,2018,19
614,NC State,2013-14,36,22,14,0.611,7301,950,2060,0.461,790,1535,0.515,160,525,0.305,501,762,0.657,2561,2013,14
615,Kansas,2014-15,36,27,9,0.75,7225,869,1976,0.44,656,1414,0.464,213,562,0.379,610,842,0.724,2561,2014,15
616,Iowa,2015-16,33,22,11,0.667,6650,906,2027,0.447,637,1308,0.487,269,719,0.374,480,669,0.717,2561,2015,16
617,Montana State,2016-17,32,16,16,0.5,6599,857,1968,0.435,537,1115,0.482,320,853,0.375,527,722,0.73,2561,2016,17
618,Mercer,2017-18,34,19,15,0.559,6900,878,1854,0.474,590,1105,0.534,288,749,0.385,517,680,0.76,2561,2017,18
619,Wright State,2018-19,35,21,14,0.6,7025,885,2028,0.436,604,1210,0.499,281,818,0.344,510,692,0.737,2561,2018,19
620,Grand Canyon,2018-19,34,20,14,0.588,6850,907,2006,0.452,650,1229,0.529,257,777,0.331,487,666,0.731,2560,2018,19
621,NW St.,2012-13,32,23,9,0.719,6400,919,2007,0.458,730,1404,0.52,189,603,0.313,532,775,0.686,2559,2012,13
622,Southern Utah,2016-17,33,6,27,0.182,6675,815,2004,0.407,524,1189,0.441,291,815,0.357,638,861,0.741,2559,2016,17
623,LSU,2017-18,33,18,15,0.545,6625,916,1926,0.476,648,1152,0.563,268,774,0.346,459,628,0.731,2559,2017,18
624,Prairie View,2017-18,34,16,18,0.471,6850,890,2043,0.436,643,1291,0.498,247,752,0.328,532,793,0.671,2559,2017,18
625,Arkansas,2018-19,34,18,16,0.529,6850,893,2004,0.446,634,1253,0.506,259,751,0.345,514,769,0.668,2559,2018,19
626,Notre Dame,2010-11,34,27,7,0.794,6900,843,1832,0.46,570,1124,0.507,273,708,0.386,599,827,0.724,2558,2010,11
627,UC-Irvine,2012-13,37,21,16,0.568,7475,932,2150,0.433,683,1404,0.486,249,746,0.334,445,669,0.665,2558,2012,13
628,Omaha,2013-14,32,17,15,0.531,6451,885,1967,0.45,666,1317,0.506,219,650,0.337,569,744,0.765,2558,2013,14
629,Fairl. Dickinson,2015-16,33,18,15,0.545,6675,929,2029,0.458,691,1372,0.504,238,657,0.362,462,663,0.697,2558,2015,16
630,Northwestern,2016-17,36,24,12,0.667,7200,913,2094,0.436,657,1347,0.488,256,747,0.343,476,637,0.747,2558,2016,17
631,Sacred Heart,2018-19,32,15,17,0.469,6424,885,1926,0.46,642,1245,0.516,243,681,0.357,545,722,0.755,2558,2018,19
632,Louisiana Tech,2016-17,33,23,10,0.697,6618,911,1952,0.467,654,1241,0.527,257,711,0.361,478,674,0.709,2557,2016,17
633,Jacksonville,2016-17,33,17,16,0.515,6626,878,1885,0.466,551,1073,0.514,327,812,0.403,474,644,0.736,2557,2016,17
634,UNC Asheville,2017-18,34,21,13,0.618,6925,912,1921,0.475,635,1218,0.521,277,703,0.394,456,615,0.741,2557,2017,18
635,App. St.,2018-19,32,11,21,0.344,6450,880,1938,0.454,588,1124,0.523,292,814,0.359,505,706,0.715,2557,2018,19
636,Cleveland State,2010-11,36,27,9,0.75,7200,859,1980,0.434,622,1285,0.484,237,695,0.341,601,822,0.731,2556,2010,11
637,Minnesota,2016-17,34,24,10,0.706,6950,887,2037,0.435,678,1427,0.475,209,610,0.343,573,806,0.711,2556,2016,17
638,ETSU,2017-18,34,25,9,0.735,6800,926,1957,0.473,682,1246,0.547,244,711,0.343,460,648,0.71,2556,2017,18
639,North Dakota St.,2018-19,35,19,16,0.543,7045,874,1926,0.454,542,1016,0.533,332,910,0.365,476,613,0.777,2556,2018,19
640,Iowa,2011-12,35,18,17,0.514,7000,902,1984,0.455,701,1445,0.485,201,539,0.373,550,763,0.721,2555,2011,12
641,Florida State,2013-14,36,22,14,0.611,7251,873,1873,0.466,682,1371,0.497,191,502,0.38,617,855,0.722,2554,2013,14
642,UT-Martin,2015-16,35,20,15,0.571,7100,888,2000,0.444,614,1211,0.507,274,789,0.347,504,711,0.709,2554,2015,16
643,Tennessee,2015-16,34,15,19,0.441,6800,890,2116,0.421,639,1349,0.474,251,767,0.327,523,721,0.725,2554,2015,16
644,UTEP,2015-16,33,19,14,0.576,6675,896,1926,0.465,673,1308,0.515,223,618,0.361,539,809,0.666,2554,2015,16
645,Colorado State,2012-13,35,26,9,0.743,7024,881,1961,0.449,701,1429,0.491,180,532,0.338,611,855,0.715,2553,2012,13
646,Missouri,2013-14,35,23,12,0.657,7075,824,1805,0.457,622,1218,0.511,202,587,0.344,703,948,0.742,2553,2013,14
647,Eastern Mich.,2015-16,33,18,15,0.545,6650,875,1961,0.446,688,1359,0.506,187,602,0.311,616,854,0.721,2553,2015,16
648,Citadel,2018-19,30,12,18,0.4,6050,899,2011,0.447,529,935,0.566,370,1076,0.344,385,523,0.736,2553,2018,19
649,Evansville,2014-15,36,24,12,0.667,7274,899,1854,0.485,746,1423,0.524,153,431,0.355,601,803,0.748,2552,2014,15
650,UNC Asheville,2015-16,34,22,12,0.647,6851,898,1973,0.455,703,1370,0.513,195,603,0.323,561,808,0.694,2552,2015,16
651,Utah State,2011-12,37,21,16,0.568,7425,896,1887,0.475,688,1321,0.521,208,566,0.367,551,766,0.719,2551,2011,12
652,Hawaii,2014-15,35,22,13,0.629,7051,901,2056,0.438,675,1354,0.499,226,702,0.322,523,762,0.686,2551,2014,15
653,Sam Houston St.,2015-16,34,18,16,0.529,6851,876,2013,0.435,612,1238,0.494,264,775,0.341,535,767,0.698,2551,2015,16
654,Washington St.,2010-11,35,22,13,0.629,7100,902,1982,0.455,662,1300,0.509,240,682,0.352,506,714,0.709,2550,2010,11
655,Baylor,2016-17,35,27,8,0.771,7000,921,1956,0.471,691,1315,0.525,230,641,0.359,478,661,0.723,2550,2016,17
656,CS Long Beach,2016-17,34,15,19,0.441,6926,895,2035,0.44,679,1419,0.479,216,616,0.351,543,750,0.724,2549,2016,17
657,Siena,2016-17,34,17,17,0.5,6825,899,1989,0.452,713,1421,0.502,186,568,0.327,565,795,0.711,2549,2016,17
658,West Virginia,2013-14,33,17,16,0.515,6651,866,1973,0.439,608,1295,0.469,258,678,0.381,556,771,0.721,2546,2013,14
659,Gardner-Webb,2016-17,33,19,14,0.576,6725,913,1905,0.479,704,1353,0.52,209,552,0.379,511,819,0.624,2546,2016,17
660,New Mexico,2011-12,35,28,7,0.8,7025,876,1898,0.462,612,1199,0.51,264,699,0.378,529,748,0.707,2545,2011,12
661,Wichita State,2011-12,33,27,6,0.818,6700,912,1892,0.482,682,1272,0.536,230,620,0.371,491,656,0.748,2545,2011,12
662,California,2015-16,34,23,11,0.676,6875,890,1931,0.461,654,1280,0.511,236,651,0.363,529,806,0.656,2545,2015,16
663,San Diego State,2017-18,33,22,11,0.667,6600,902,1967,0.459,663,1258,0.527,239,709,0.337,502,702,0.715,2545,2017,18
664,CS Long Beach,2018-19,34,15,19,0.441,6875,877,2031,0.432,660,1401,0.471,217,630,0.344,574,831,0.691,2545,2018,19
665,UNC Asheville,2016-17,33,23,10,0.697,6725,908,1908,0.476,644,1238,0.52,264,670,0.394,464,681,0.681,2544,2016,17
666,Xavier,2011-12,36,23,13,0.639,7275,899,1986,0.453,723,1485,0.487,176,501,0.351,569,819,0.695,2543,2011,12
667,Minnesota,2018-19,36,22,14,0.611,7220,887,2039,0.435,696,1436,0.485,191,603,0.317,578,848,0.682,2543,2018,19
668,West Virginia,2014-15,35,25,10,0.714,7050,872,2138,0.408,645,1419,0.455,227,719,0.316,571,863,0.662,2542,2014,15
669,N.C. Central,2016-17,34,25,9,0.735,6800,910,2005,0.454,655,1244,0.527,255,761,0.335,467,684,0.683,2542,2016,17
670,UNC Wilmington,2017-18,32,11,21,0.344,6525,920,2109,0.436,676,1404,0.481,244,705,0.346,458,664,0.69,2542,2017,18
671,Manhattan,2013-14,33,25,8,0.758,6749,828,1837,0.451,620,1273,0.487,208,564,0.369,676,1019,0.663,2540,2013,14
672,LSU,2013-14,34,20,14,0.588,6876,918,2067,0.444,687,1392,0.494,231,675,0.342,473,707,0.669,2540,2013,14
673,Army,2015-16,33,19,14,0.576,6750,895,2084,0.429,601,1207,0.498,294,877,0.335,455,656,0.694,2539,2015,16
674,Middle Tenn.,2015-16,35,25,10,0.714,7025,909,2025,0.449,630,1309,0.481,279,716,0.39,442,718,0.616,2539,2015,16
675,Texas-Arlington,2011-12,33,24,9,0.727,6625,842,1884,0.447,613,1237,0.496,229,647,0.354,624,888,0.703,2537,2011,12
676,Toledo,2018-19,33,25,8,0.758,6651,901,1990,0.453,576,1131,0.509,325,859,0.378,410,531,0.772,2537,2018,19
677,Maryland,2010-11,33,19,14,0.576,6600,932,1980,0.471,781,1546,0.505,151,434,0.348,521,770,0.677,2536,2010,11
678,La Salle,2010-11,33,15,18,0.455,6800,923,2070,0.446,715,1499,0.477,208,571,0.364,482,680,0.709,2536,2010,11
679,Charleston,2017-18,34,26,8,0.765,6925,875,1905,0.459,616,1185,0.52,259,720,0.36,527,699,0.754,2536,2017,18
680,UAB,2017-18,33,20,13,0.606,6650,945,1937,0.488,722,1291,0.559,223,646,0.345,423,564,0.75,2536,2017,18
681,Louisville,2018-19,34,20,14,0.588,6900,854,1967,0.434,560,1107,0.506,294,860,0.342,534,687,0.777,2536,2018,19
682,Wichita State,2015-16,35,26,9,0.743,7050,867,2023,0.429,617,1252,0.493,250,771,0.324,551,768,0.717,2535,2015,16
683,Washington,2017-18,34,21,13,0.618,6875,900,1963,0.458,670,1299,0.516,230,664,0.346,505,720,0.701,2535,2017,18
684,Southern,2015-16,35,22,13,0.629,7000,909,2046,0.444,698,1436,0.486,211,610,0.346,505,754,0.67,2534,2015,16
685,St. John's (NY),2016-17,33,14,19,0.424,6600,866,2000,0.433,588,1237,0.475,278,763,0.364,524,722,0.726,2534,2016,17
686,William & Mary,2016-17,31,17,14,0.548,6250,887,1808,0.491,604,1068,0.566,283,740,0.382,477,689,0.692,2534,2016,17
687,Bucknell,2018-19,33,21,12,0.636,6625,867,1928,0.45,556,1043,0.533,311,885,0.351,489,653,0.749,2534,2018,19
688,Oakland,2018-19,33,16,17,0.485,6625,864,1859,0.465,550,1043,0.527,314,816,0.385,492,663,0.742,2534,2018,19
689,S Dakota St.,2010-11,31,19,12,0.613,6200,884,1901,0.465,608,1229,0.495,276,672,0.411,489,672,0.728,2533,2010,11
690,Belmont,2012-13,33,26,7,0.788,6625,906,1844,0.491,627,1115,0.562,279,729,0.383,442,604,0.732,2533,2012,13
691,California,2013-14,35,21,14,0.6,7078,921,2014,0.457,722,1438,0.502,199,576,0.345,492,717,0.686,2533,2013,14
692,Delaware State,2014-15,36,18,18,0.5,7225,888,2121,0.419,606,1323,0.458,282,798,0.353,475,672,0.707,2533,2014,15
693,Robert Morris,2011-12,37,26,11,0.703,7425,844,2020,0.418,604,1338,0.451,240,682,0.352,604,862,0.701,2532,2011,12
694,Iona,2018-19,33,17,16,0.515,6600,857,1897,0.452,560,1052,0.532,297,845,0.351,521,699,0.745,2532,2018,19
695,San Diego State,2013-14,36,31,5,0.861,7251,873,2009,0.435,687,1490,0.461,186,519,0.358,598,902,0.663,2530,2013,14
696,Davidson,2014-15,32,24,8,0.75,6425,898,1924,0.467,555,1047,0.53,343,877,0.391,390,553,0.705,2529,2014,15
697,Oregon,2011-12,34,24,10,0.706,6800,883,1884,0.469,637,1226,0.52,246,658,0.374,515,726,0.709,2527,2011,12
698,BYU,2018-19,32,19,13,0.594,6473,878,1878,0.468,652,1194,0.546,226,684,0.33,545,750,0.727,2527,2018,19
699,North Dakota,2013-14,34,17,17,0.5,6797,889,1951,0.456,689,1340,0.514,200,611,0.327,548,797,0.688,2526,2013,14
700,Canisius,2015-16,33,14,19,0.424,6775,845,2014,0.42,560,1178,0.475,285,836,0.341,551,744,0.741,2526,2015,16
,,,,,,,,School,School,School,School,School,School,School,School,School,School,School,School,School,,
,Schl,Season,G,W,L,W-L%,MP,FG,FGA,FG%,2P,2PA,2P%,3P,3PA,3P%,FT,FTA,FT%,PTS,Season,
701,Evansville,2015-16,34,25,9,0.735,6850,879,1795,0.49,721,1347,0.535,158,448,0.353,610,843,0.724,2526,2015,16
702,Sam Houston St.,2016-17,34,21,13,0.618,6825,898,2055,0.437,686,1384,0.496,212,671,0.316,518,755,0.686,2526,2016,17
703,Xavier,2018-19,35,19,16,0.543,7100,922,1977,0.466,677,1237,0.547,245,740,0.331,437,644,0.679,2526,2018,19
704,NC State,2014-15,36,22,14,0.611,7252,895,2054,0.436,659,1393,0.473,236,661,0.357,499,727,0.686,2525,2014,15
705,UC-Davis,2016-17,36,23,13,0.639,7275,873,2008,0.435,652,1373,0.475,221,635,0.348,558,828,0.674,2525,2016,17
706,Akron,2010-11,36,23,13,0.639,7325,892,2073,0.43,609,1288,0.473,283,785,0.361,457,649,0.704,2524,2010,11
707,Memphis,2010-11,35,25,10,0.714,7075,891,1975,0.451,681,1336,0.51,210,639,0.329,532,782,0.68,2524,2010,11
708,Western Caro.,2013-14,34,19,15,0.559,6903,868,2041,0.425,620,1335,0.464,248,706,0.351,540,754,0.716,2524,2013,14
709,Charleston So.,2013-14,31,13,18,0.419,6325,859,1876,0.458,557,1087,0.512,302,789,0.383,503,689,0.73,2523,2013,14
710,Kansas State,2016-17,35,21,14,0.6,7025,869,1883,0.461,622,1200,0.518,247,683,0.362,538,775,0.694,2523,2016,17
711,Omaha,2018-19,32,21,11,0.656,6446,950,1998,0.475,668,1279,0.522,282,719,0.392,341,473,0.721,2523,2018,19
712,Cincinnati,2011-12,37,26,11,0.703,7500,924,2194,0.421,664,1431,0.464,260,763,0.341,414,643,0.644,2522,2011,12
713,Seton Hall,2015-16,34,25,9,0.735,6825,892,1999,0.446,686,1405,0.488,206,594,0.347,532,808,0.658,2522,2015,16
714,Fairfield,2015-16,33,19,14,0.576,6726,875,1991,0.439,582,1164,0.5,293,827,0.354,479,650,0.737,2522,2015,16
715,Washington St.,2011-12,37,19,18,0.514,7424,860,1836,0.468,632,1213,0.521,228,623,0.366,573,808,0.709,2521,2011,12
716,Quinnipiac,2013-14,32,20,12,0.625,6450,835,1968,0.424,662,1483,0.446,173,485,0.357,678,947,0.716,2521,2013,14
717,N.C. Central,2017-18,35,19,16,0.543,7024,949,2060,0.461,737,1420,0.519,212,640,0.331,410,597,0.687,2520,2017,18
718,App. St.,2017-18,33,15,18,0.455,6700,864,1983,0.436,572,1124,0.509,292,859,0.34,500,749,0.668,2520,2017,18
719,George Mason,2016-17,34,20,14,0.588,6925,879,1962,0.448,697,1420,0.491,182,542,0.336,579,775,0.747,2519,2016,17
720,Davidson,2017-18,33,21,12,0.636,6675,899,1874,0.48,546,967,0.565,353,907,0.389,368,461,0.798,2519,2017,18
721,Canisius,2017-18,33,21,12,0.636,6625,901,1942,0.464,597,1068,0.559,304,874,0.348,413,581,0.711,2519,2017,18
722,USC,2018-19,33,16,17,0.485,6700,937,2039,0.46,656,1304,0.503,281,735,0.382,363,563,0.645,2518,2018,19
723,Marquette,2015-16,33,20,13,0.606,6700,884,1888,0.468,690,1316,0.524,194,572,0.339,555,764,0.726,2517,2015,16
724,Green Bay,2017-18,33,13,20,0.394,6650,859,2027,0.424,564,1214,0.465,295,813,0.363,504,670,0.752,2517,2017,18
725,St. Francis (PA),2018-19,33,18,15,0.545,6597,885,2035,0.435,631,1311,0.481,254,724,0.351,493,698,0.706,2517,2018,19
726,North Texas,2010-11,33,22,11,0.667,6626,831,1735,0.479,652,1261,0.517,179,474,0.378,675,900,0.75,2516,2010,11
727,New Mexico,2013-14,34,27,7,0.794,6899,847,1851,0.458,650,1258,0.517,197,593,0.332,625,863,0.724,2516,2013,14
728,Detroit,2017-18,32,8,24,0.25,6425,883,2031,0.435,602,1216,0.495,281,815,0.345,469,621,0.755,2516,2017,18
729,ETSU,2010-11,36,24,12,0.667,7250,873,1924,0.454,684,1384,0.494,189,540,0.35,580,856,0.678,2515,2010,11
730,Stony Brook,2015-16,33,26,7,0.788,6625,933,1992,0.468,713,1394,0.511,220,598,0.368,429,637,0.673,2515,2015,16
731,Michigan State,2016-17,35,20,15,0.571,7025,905,1927,0.47,632,1195,0.529,273,732,0.373,432,646,0.669,2515,2016,17
732,Murray State,2017-18,32,26,6,0.813,6400,870,1803,0.483,599,1084,0.553,271,719,0.377,504,687,0.734,2515,2017,18
733,UNC Wilmington,2018-19,33,10,23,0.303,6673,880,1986,0.443,620,1242,0.499,260,744,0.349,493,673,0.733,2515,2018,19
734,Pitt,2010-11,34,28,6,0.824,6825,886,1866,0.475,684,1354,0.505,202,512,0.395,540,805,0.671,2514,2010,11
735,Purdue,2011-12,35,22,13,0.629,7000,889,2019,0.44,605,1266,0.478,284,753,0.377,452,689,0.656,2514,2011,12
736,UC-Irvine,2016-17,36,21,15,0.583,7250,915,2062,0.444,650,1328,0.489,265,734,0.361,419,611,0.686,2514,2016,17
737,Ole Miss,2010-11,34,20,14,0.588,6825,868,1964,0.442,608,1224,0.497,260,740,0.351,517,684,0.756,2513,2010,11
738,N.C. Central,2013-14,34,28,6,0.824,6901,847,1832,0.462,663,1287,0.515,184,545,0.338,635,872,0.728,2513,2013,14
739,Arizona State,2012-13,35,22,13,0.629,7125,902,1964,0.459,652,1242,0.525,250,722,0.346,458,706,0.649,2512,2012,13
740,Grand Canyon,2017-18,34,22,12,0.647,6850,855,1992,0.429,604,1213,0.498,251,779,0.322,551,785,0.702,2512,2017,18
741,Austin Peay,2017-18,34,19,15,0.559,6851,915,2012,0.455,713,1420,0.502,202,592,0.341,480,737,0.651,2512,2017,18
742,Utah,2016-17,32,20,12,0.625,6448,936,1856,0.504,721,1247,0.578,215,609,0.353,424,622,0.682,2511,2016,17
743,Washington,2018-19,36,27,9,0.75,7225,883,1956,0.451,610,1176,0.519,273,780,0.35,472,679,0.695,2511,2018,19
744,Austin Peay,2010-11,34,20,14,0.588,6950,899,1960,0.459,713,1443,0.494,186,517,0.36,526,773,0.68,2510,2010,11
745,CS Long Beach,2011-12,34,25,9,0.735,6850,880,1880,0.468,659,1262,0.522,221,618,0.358,529,790,0.67,2510,2011,12
746,Cincinnati,2018-19,35,28,7,0.8,7050,872,2018,0.432,640,1345,0.476,232,673,0.345,534,758,0.704,2510,2018,19
747,Miami (FL),2012-13,36,29,7,0.806,7225,895,1968,0.455,641,1267,0.506,254,701,0.362,465,680,0.684,2509,2012,13
748,Eastern Mich.,2017-18,35,22,13,0.629,7075,933,2010,0.464,699,1312,0.533,234,698,0.335,409,599,0.683,2509,2017,18
749,Illinois,2016-17,35,20,15,0.571,7025,898,2019,0.445,628,1288,0.488,270,731,0.369,442,643,0.687,2508,2016,17
750,Seton Hall,2018-19,34,20,14,0.588,6875,888,2021,0.439,648,1280,0.506,240,741,0.324,492,697,0.706,2508,2018,19
751,Vermont,2018-19,34,27,7,0.794,6850,864,1887,0.458,591,1126,0.525,273,761,0.359,507,678,0.748,2508,2018,19
752,VCU,2017-18,33,18,15,0.545,6675,921,2013,0.458,647,1235,0.524,274,778,0.352,391,566,0.691,2507,2017,18
753,IUPUI,2018-19,33,16,17,0.485,6600,891,1969,0.453,657,1274,0.516,234,695,0.337,491,699,0.702,2507,2018,19
754,UNC Asheville,2010-11,34,20,14,0.588,6951,881,1950,0.452,713,1435,0.497,168,515,0.326,576,810,0.711,2506,2010,11
755,Texas State,2010-11,32,16,16,0.5,6450,866,1930,0.449,681,1351,0.504,185,579,0.32,589,877,0.672,2506,2010,11
756,Vanderbilt,2015-16,33,19,14,0.576,6649,857,1879,0.456,584,1165,0.501,273,714,0.382,519,747,0.695,2506,2015,16
757,Fairfield,2017-18,33,17,16,0.515,6725,881,2009,0.439,578,1116,0.518,303,893,0.339,441,621,0.71,2506,2017,18
758,Penn,2017-18,33,24,9,0.727,6775,893,1948,0.458,602,1117,0.539,291,831,0.35,429,651,0.659,2506,2017,18
759,Drake,2017-18,34,17,17,0.5,6950,862,1972,0.437,573,1177,0.487,289,795,0.364,493,640,0.77,2506,2017,18
760,Northern Ill.,2018-19,34,17,17,0.5,6875,940,1995,0.471,711,1353,0.525,229,642,0.357,397,543,0.731,2506,2018,19
761,Tx-Rio Grande,2016-17,32,10,22,0.313,6525,869,2050,0.424,593,1229,0.483,276,821,0.336,491,685,0.717,2505,2016,17
762,Fla. Gulf Coast,2013-14,35,22,13,0.629,7043,914,1958,0.467,714,1350,0.529,200,608,0.329,476,706,0.674,2504,2013,14
763,Mt. St. Mary's,2013-14,33,16,17,0.485,6650,843,1923,0.438,547,1089,0.502,296,834,0.355,522,706,0.739,2504,2013,14
764,Central Mich.,2014-15,32,23,9,0.719,6426,848,1816,0.467,526,952,0.553,322,864,0.373,486,670,0.725,2504,2014,15
765,Ga. Southern,2017-18,33,21,12,0.636,6625,857,1992,0.43,590,1208,0.488,267,784,0.341,523,789,0.663,2504,2017,18
766,Indiana,2018-19,35,19,16,0.543,7100,919,2009,0.457,708,1333,0.531,211,676,0.312,455,695,0.655,2504,2018,19
767,Western Caro.,2011-12,35,17,18,0.486,7100,885,2090,0.423,622,1342,0.463,263,748,0.352,470,681,0.69,2503,2011,12
768,Wofford,2010-11,34,21,13,0.618,6950,883,1853,0.477,686,1360,0.504,197,493,0.4,539,778,0.693,2502,2010,11
769,Toledo,2011-12,36,19,17,0.528,7200,871,1916,0.455,654,1328,0.492,217,588,0.369,543,748,0.726,2502,2011,12
770,Saint Mary's,2013-14,35,23,12,0.657,7028,819,1818,0.45,573,1178,0.486,246,640,0.384,618,873,0.708,2502,2013,14
771,UMass,2013-14,33,24,9,0.727,6625,900,1962,0.459,723,1450,0.499,177,512,0.346,525,769,0.683,2502,2013,14
772,Cal St Bakersfield,2016-17,35,25,10,0.714,7125,895,2035,0.44,666,1383,0.482,229,652,0.351,483,755,0.64,2502,2016,17
773,Boise State,2017-18,32,23,9,0.719,6500,878,1903,0.461,571,1094,0.522,307,809,0.379,439,595,0.738,2502,2017,18
774,Abilene Christ.,2018-19,34,27,7,0.794,6850,897,1911,0.469,646,1251,0.516,251,660,0.38,457,642,0.712,2502,2018,19
775,Montana State,2018-19,32,15,17,0.469,6400,858,1882,0.456,552,1064,0.519,306,818,0.374,480,651,0.737,2502,2018,19
776,Oklahoma,2014-15,35,24,11,0.686,7050,885,2035,0.435,649,1347,0.482,236,688,0.343,495,668,0.741,2501,2014,15
777,Arkansas,2015-16,32,16,16,0.5,6525,883,1992,0.443,667,1448,0.461,216,544,0.397,519,748,0.694,2501,2015,16
778,IUPUI,2016-17,32,14,18,0.438,6450,883,1957,0.451,595,1214,0.49,288,743,0.388,446,653,0.683,2500,2016,17
779,Lamar,2017-18,33,19,14,0.576,6700,873,2026,0.431,616,1276,0.483,257,750,0.343,497,757,0.657,2500,2017,18
780,Wright State,2017-18,35,25,10,0.714,7050,873,2019,0.432,636,1316,0.483,237,703,0.337,517,723,0.715,2500,2017,18
781,Marshall,2010-11,34,22,12,0.647,6825,854,1887,0.453,666,1304,0.511,188,583,0.322,603,888,0.679,2499,2010,11
782,Canisius,2012-13,34,20,14,0.588,6850,857,1923,0.446,544,1112,0.489,313,811,0.386,472,659,0.716,2499,2012,13
783,Georgia State,2014-15,35,25,10,0.714,7076,902,1878,0.48,728,1356,0.537,174,522,0.333,521,719,0.725,2499,2014,15
784,Winthrop,2018-19,30,18,12,0.6,6050,855,1878,0.455,483,881,0.548,372,997,0.373,417,565,0.738,2499,2018,19
785,Rider,2016-17,33,18,15,0.545,6625,907,2034,0.446,728,1495,0.487,179,539,0.332,505,752,0.672,2498,2016,17
786,Eastern Ky.,2015-16,31,15,16,0.484,6200,864,1760,0.491,606,1107,0.547,258,653,0.395,511,700,0.73,2497,2015,16
787,UNLV,2012-13,35,25,10,0.714,7024,872,2002,0.436,645,1313,0.491,227,689,0.329,525,747,0.703,2496,2012,13
788,Utah,2014-15,35,26,9,0.743,7024,849,1760,0.482,585,1106,0.529,264,654,0.404,534,760,0.703,2496,2014,15
789,Georgia Tech,2016-17,37,21,16,0.568,7425,910,2079,0.438,739,1563,0.473,171,516,0.331,505,740,0.682,2496,2016,17
790,Albany (NY),2016-17,35,21,14,0.6,7000,907,1941,0.467,715,1425,0.502,192,516,0.372,490,647,0.757,2496,2016,17
791,Butler,2012-13,36,27,9,0.75,7226,869,1931,0.45,630,1243,0.507,239,688,0.347,518,744,0.696,2495,2012,13
792,Central Mich.,2015-16,33,17,16,0.515,6625,867,1964,0.441,543,1047,0.519,324,917,0.353,437,608,0.719,2495,2015,16
793,Albany (NY),2015-16,33,24,9,0.727,6676,848,1850,0.458,660,1263,0.523,188,587,0.32,611,814,0.751,2495,2015,16
794,Campbell,2018-19,33,20,13,0.606,6625,867,1906,0.455,554,994,0.557,313,912,0.343,448,590,0.759,2495,2018,19
795,Duquesne,2010-11,32,19,13,0.594,6475,872,1905,0.458,616,1193,0.516,256,712,0.36,494,794,0.622,2494,2010,11
796,Norfolk State,2015-16,34,17,17,0.5,6850,813,1919,0.424,571,1222,0.467,242,697,0.347,626,808,0.775,2494,2015,16
797,North Dakota St.,2013-14,33,26,7,0.788,6625,888,1759,0.505,712,1276,0.558,176,483,0.364,540,719,0.751,2492,2013,14
798,USC Upstate,2013-14,34,19,15,0.559,6888,890,1966,0.453,680,1300,0.523,210,666,0.315,502,744,0.675,2492,2013,14
799,Boston U.,2013-14,35,24,11,0.686,7101,894,1978,0.452,612,1202,0.509,282,776,0.363,422,591,0.714,2492,2013,14
800,Ga. Southern,2016-17,33,18,15,0.545,6622,841,1909,0.441,538,1072,0.502,303,837,0.362,507,763,0.664,2492,2016,17
,,,,,,,,School,School,School,School,School,School,School,School,School,School,School,School,School,,
,Schl,Season,G,W,L,W-L%,MP,FG,FGA,FG%,2P,2PA,2P%,3P,3PA,3P%,FT,FTA,FT%,PTS,Season,
801,Iowa State,2011-12,34,23,11,0.676,6800,847,1888,0.449,554,1102,0.503,293,786,0.373,503,731,0.688,2490,2011,12
802,Davidson,2012-13,34,26,8,0.765,6825,837,1813,0.462,581,1119,0.519,256,694,0.369,560,704,0.795,2490,2012,13
803,Evansville,2012-13,36,21,15,0.583,7275,900,2056,0.438,693,1490,0.465,207,566,0.366,483,652,0.741,2490,2012,13
804,Tx-Rio Grande,2017-18,33,15,18,0.455,6650,833,2061,0.404,628,1398,0.449,205,663,0.309,619,835,0.741,2490,2017,18
805,CS Long Beach,2010-11,34,22,12,0.647,6825,862,1931,0.446,643,1295,0.497,219,636,0.344,546,812,0.672,2489,2010,11
806,Liberty,2012-13,36,15,21,0.417,7275,838,1954,0.429,587,1285,0.457,251,669,0.375,562,770,0.73,2489,2012,13
807,Chattanooga,2013-14,33,18,15,0.545,6649,832,1922,0.433,616,1271,0.485,216,651,0.332,609,866,0.703,2489,2013,14
808,Vanderbilt,2016-17,35,19,16,0.543,7025,815,1896,0.43,469,975,0.481,346,921,0.376,513,660,0.777,2489,2016,17
809,Utah State,2017-18,34,17,17,0.5,6825,865,1904,0.454,548,1034,0.53,317,870,0.364,442,627,0.705,2489,2017,18
810,Furman,2015-16,35,19,16,0.543,7000,847,1865,0.454,594,1080,0.55,253,785,0.322,540,777,0.695,2487,2015,16
811,Little Rock,2015-16,35,30,5,0.857,7074,886,1958,0.453,620,1265,0.49,266,693,0.384,449,616,0.729,2487,2015,16
812,Rider,2010-11,34,23,11,0.676,6850,894,1916,0.467,631,1244,0.507,263,672,0.391,435,670,0.649,2486,2010,11
813,Arizona State,2013-14,33,21,12,0.636,6725,836,1852,0.451,568,1164,0.488,268,688,0.39,546,787,0.694,2486,2013,14
814,UNC Asheville,2013-14,32,17,15,0.531,6451,836,1832,0.456,613,1231,0.498,223,601,0.371,591,793,0.745,2486,2013,14
815,Buffalo,2016-17,32,17,15,0.531,6425,877,1945,0.451,637,1218,0.523,240,727,0.33,492,711,0.692,2486,2016,17
816,Northern Ky.,2017-18,32,22,10,0.688,6400,898,1892,0.475,640,1136,0.563,258,756,0.341,432,591,0.731,2486,2017,18
817,SC St.,2015-16,34,19,15,0.559,6800,885,1955,0.453,684,1366,0.501,201,589,0.341,514,716,0.718,2485,2015,16
818,Savannah State,2016-17,29,13,16,0.448,5825,833,2030,0.41,441,848,0.52,392,1182,0.332,427,659,0.648,2485,2016,17
819,CS Long Beach,2017-18,33,15,18,0.455,6650,866,1917,0.452,670,1359,0.493,196,558,0.351,557,765,0.728,2485,2017,18
820,North Florida,2018-19,33,16,17,0.485,6625,902,2014,0.448,594,1117,0.532,308,897,0.343,373,539,0.692,2485,2018,19
821,Ole Miss,2018-19,33,20,13,0.606,6625,876,1906,0.46,604,1146,0.527,272,760,0.358,461,589,0.783,2485,2018,19
822,Kent State,2012-13,35,21,14,0.6,7126,823,1921,0.428,582,1252,0.465,241,669,0.36,597,842,0.709,2484,2012,13
823,Oral Roberts,2012-13,35,20,15,0.571,7055,890,1931,0.461,725,1464,0.495,165,467,0.353,539,730,0.738,2484,2012,13
824,Pacific,2013-14,34,18,16,0.529,6827,842,1889,0.446,626,1289,0.486,216,600,0.36,584,763,0.765,2484,2013,14
825,Niagara,2013-14,33,7,26,0.212,6601,836,1949,0.429,670,1395,0.48,166,554,0.3,646,947,0.682,2484,2013,14
826,Louisville,2014-15,36,27,9,0.75,7249,878,2048,0.429,680,1404,0.484,198,644,0.307,529,792,0.668,2483,2014,15
827,Toledo,2014-15,33,20,13,0.606,6650,863,1837,0.47,668,1304,0.512,195,533,0.366,562,757,0.742,2483,2014,15
828,Boston U.,2015-16,34,19,15,0.559,6876,859,1893,0.454,587,1145,0.513,272,748,0.364,493,688,0.717,2483,2015,16
829,Portland,2015-16,32,12,20,0.375,6425,868,2012,0.431,579,1225,0.473,289,787,0.367,458,633,0.724,2483,2015,16
830,NC State,2016-17,32,15,17,0.469,6450,888,1898,0.468,662,1263,0.524,226,635,0.356,481,687,0.7,2483,2016,17
831,Samford,2017-18,32,10,22,0.313,6401,870,1846,0.471,581,1072,0.542,289,774,0.373,454,594,0.764,2483,2017,18
832,Norfolk State,2011-12,36,26,10,0.722,7275,870,1977,0.44,672,1342,0.501,198,635,0.312,544,829,0.656,2482,2011,12
833,Ole Miss,2013-14,33,19,14,0.576,6676,836,2003,0.417,578,1242,0.465,258,761,0.339,552,793,0.696,2482,2013,14
834,NC State,2015-16,33,16,17,0.485,6650,866,1999,0.433,659,1404,0.469,207,595,0.348,543,777,0.699,2482,2015,16
835,Toledo,2015-16,32,17,15,0.531,6400,865,1881,0.46,602,1159,0.519,263,722,0.364,489,655,0.747,2482,2015,16
836,Kent State,2017-18,34,17,17,0.5,6850,871,2049,0.425,616,1267,0.486,255,782,0.326,485,666,0.728,2482,2017,18
837,UTSA,2018-19,32,17,15,0.531,6475,896,2068,0.433,602,1213,0.496,294,855,0.344,395,536,0.737,2481,2018,19
838,Kent State,2018-19,33,22,11,0.667,6650,878,2032,0.432,617,1257,0.491,261,775,0.337,464,641,0.724,2481,2018,19
839,Robert Morris,2012-13,35,24,11,0.686,7025,825,1912,0.431,525,1124,0.467,300,788,0.381,530,708,0.749,2480,2012,13
840,Boise State,2015-16,32,20,12,0.625,6451,842,1859,0.453,581,1071,0.542,261,788,0.331,535,755,0.709,2480,2015,16
841,UCLA,2015-16,32,15,17,0.469,6475,915,2016,0.454,715,1465,0.488,200,551,0.363,450,651,0.691,2480,2015,16
842,Hawaii,2013-14,31,20,11,0.645,6275,866,1829,0.473,689,1301,0.53,177,528,0.335,570,789,0.722,2479,2013,14
843,Utah,2013-14,33,21,12,0.636,6676,869,1781,0.488,665,1200,0.554,204,581,0.351,537,723,0.743,2479,2013,14
844,Ball State,2015-16,35,21,14,0.6,7150,855,1919,0.446,550,1101,0.5,305,818,0.373,464,670,0.693,2479,2015,16
845,Western Caro.,2015-16,34,16,18,0.471,6925,851,1993,0.427,609,1263,0.482,242,730,0.332,535,760,0.704,2479,2015,16
846,Middle Tenn.,2017-18,33,25,8,0.758,6648,902,1914,0.471,661,1266,0.522,241,648,0.372,434,585,0.742,2479,2017,18
847,Lehigh,2018-19,31,20,11,0.645,6241,856,1775,0.482,569,1096,0.519,287,679,0.423,480,620,0.774,2479,2018,19
848,La Salle,2011-12,34,21,13,0.618,6850,898,1937,0.464,633,1284,0.493,265,653,0.406,417,578,0.721,2478,2011,12
849,Ball State,2018-19,33,16,17,0.485,6697,889,1892,0.47,687,1271,0.541,202,621,0.325,498,709,0.702,2478,2018,19
850,South Alabama,2018-19,34,17,17,0.5,6875,867,1883,0.46,582,1122,0.519,285,761,0.375,459,669,0.686,2478,2018,19
851,Kansas State,2010-11,34,23,11,0.676,6800,849,1939,0.438,612,1308,0.468,237,631,0.376,542,828,0.655,2477,2010,11
852,East Carolina,2013-14,34,17,17,0.5,6800,809,1833,0.441,520,1047,0.497,289,786,0.368,570,799,0.713,2477,2013,14
853,Hartford,2018-19,33,18,15,0.545,6725,848,1862,0.455,526,1016,0.518,322,846,0.381,459,619,0.742,2477,2018,19
854,Radford,2014-15,34,22,12,0.647,6900,892,1946,0.458,680,1312,0.518,212,634,0.334,480,695,0.691,2476,2014,15
855,UAB,2014-15,36,20,16,0.556,7401,873,2042,0.428,671,1435,0.468,202,607,0.333,528,715,0.738,2476,2014,15
856,Gardner-Webb,2015-16,33,17,16,0.515,6675,871,2039,0.427,595,1232,0.483,276,807,0.342,458,701,0.653,2476,2015,16
857,Pitt,2015-16,33,21,12,0.636,6651,878,1919,0.458,674,1330,0.507,204,589,0.346,516,686,0.752,2476,2015,16
858,Houston,2015-16,32,22,10,0.688,6525,897,1926,0.466,682,1308,0.521,215,618,0.348,467,662,0.705,2476,2015,16
859,Sam Houston St.,2018-19,33,21,12,0.636,6722,889,2011,0.442,581,1171,0.496,308,840,0.367,390,518,0.753,2476,2018,19
860,Ole Miss,2014-15,34,21,13,0.618,6845,848,2003,0.423,628,1341,0.468,220,662,0.332,559,723,0.773,2475,2014,15
861,Northern Iowa,2015-16,36,23,13,0.639,7275,849,1864,0.455,551,1068,0.516,298,796,0.374,479,633,0.757,2475,2015,16
862,Troy,2017-18,33,16,17,0.485,6650,848,1930,0.439,556,1064,0.523,292,866,0.337,487,662,0.736,2475,2017,18
863,Portland State,2018-19,32,16,16,0.5,6450,856,2017,0.424,618,1248,0.495,238,769,0.309,525,748,0.702,2475,2018,19
864,George Mason,2010-11,34,27,7,0.794,6875,876,1861,0.471,649,1287,0.504,227,574,0.395,495,718,0.689,2474,2010,11
865,North Dakota,2015-16,33,17,16,0.515,6700,876,1926,0.455,673,1361,0.494,203,565,0.359,519,761,0.682,2474,2015,16
866,Alabama,2010-11,37,25,12,0.676,7450,930,2066,0.45,778,1556,0.5,152,510,0.298,461,652,0.707,2473,2010,11
867,Weber State,2011-12,32,25,7,0.781,6475,825,1797,0.459,540,1069,0.505,285,728,0.391,538,661,0.814,2473,2011,12
868,High Point,2015-16,32,21,11,0.656,6450,884,1852,0.477,697,1365,0.511,187,487,0.384,518,680,0.762,2473,2015,16
869,Hofstra,2016-17,32,15,17,0.469,6450,846,1908,0.443,555,1116,0.497,291,792,0.367,490,716,0.684,2473,2016,17
870,Marshall,2011-12,35,21,14,0.6,7125,895,2052,0.436,692,1403,0.493,203,649,0.313,479,780,0.614,2472,2011,12
871,Vanderbilt,2014-15,35,21,14,0.6,7099,838,1775,0.472,583,1124,0.519,255,651,0.392,541,764,0.708,2472,2014,15
872,Northeastern,2017-18,33,23,10,0.697,6675,859,1776,0.484,557,972,0.573,302,804,0.376,452,617,0.733,2472,2017,18
873,NJIT,2018-19,35,22,13,0.629,7050,849,1913,0.444,603,1200,0.503,246,713,0.345,528,732,0.721,2472,2018,19
874,Tulsa,2013-14,34,21,13,0.618,6850,835,1899,0.44,638,1296,0.492,197,603,0.327,604,894,0.676,2471,2013,14
875,La.-Monroe,2015-16,34,20,14,0.588,6950,896,1956,0.458,671,1320,0.508,225,636,0.354,454,647,0.702,2471,2015,16
876,Stetson,2016-17,32,11,21,0.344,6425,886,2007,0.441,625,1237,0.505,261,770,0.339,438,665,0.659,2471,2016,17
877,UTEP,2010-11,35,25,10,0.714,7075,878,1886,0.466,679,1339,0.507,199,547,0.364,515,769,0.67,2470,2010,11
878,Texas,2011-12,34,20,14,0.588,6850,836,1927,0.434,639,1326,0.482,197,601,0.328,601,820,0.733,2470,2011,12
879,Louisiana Tech,2012-13,34,27,7,0.794,6800,857,2092,0.41,604,1305,0.463,253,787,0.321,503,722,0.697,2470,2012,13
880,UAB,2018-19,35,20,15,0.571,7050,906,2003,0.452,672,1309,0.513,234,694,0.337,424,630,0.673,2470,2018,19
881,Texas State,2018-19,34,24,10,0.706,6850,876,1971,0.444,632,1227,0.515,244,744,0.328,474,694,0.683,2470,2018,19
882,San Francisco,2013-14,33,21,12,0.636,6703,861,1819,0.473,637,1201,0.53,224,618,0.362,523,807,0.648,2469,2013,14
883,UNC Greensboro,2015-16,34,15,19,0.441,6850,890,1997,0.446,594,1182,0.503,296,815,0.363,393,579,0.679,2469,2015,16
884,UC-Irvine,2013-14,35,23,12,0.657,7076,909,1932,0.47,712,1375,0.518,197,557,0.354,453,707,0.641,2468,2013,14
885,Clemson,2016-17,33,17,16,0.515,6625,871,1939,0.449,632,1270,0.498,239,669,0.357,487,666,0.731,2468,2016,17
886,Louisiana Tech,2017-18,33,17,16,0.515,6624,838,1877,0.446,551,1112,0.496,287,765,0.375,505,697,0.725,2468,2017,18
887,Saint Mary's,2011-12,33,27,6,0.818,6625,857,1811,0.473,612,1098,0.557,245,713,0.344,508,697,0.729,2467,2011,12
888,Oral Roberts,2011-12,34,27,7,0.794,6875,864,1786,0.484,682,1279,0.533,182,507,0.359,557,747,0.746,2467,2011,12
889,Purdue,2010-11,34,26,8,0.765,6825,875,1957,0.447,640,1312,0.488,235,645,0.364,481,673,0.715,2466,2010,11
890,Syracuse,2017-18,37,23,14,0.622,7500,832,1995,0.417,624,1340,0.466,208,655,0.318,594,807,0.736,2466,2017,18
891,Illinois,2012-13,36,23,13,0.639,7225,858,2084,0.412,578,1211,0.477,280,873,0.321,469,646,0.726,2465,2012,13
892,Milwaukee,2013-14,35,21,14,0.6,7076,808,1888,0.428,563,1134,0.496,245,754,0.325,604,823,0.734,2465,2013,14
893,Wright State,2016-17,32,20,12,0.625,6450,817,1819,0.449,532,1070,0.497,285,749,0.381,546,715,0.764,2465,2016,17
894,Valparaiso,2016-17,33,24,9,0.727,6650,848,1912,0.444,631,1242,0.508,217,670,0.324,552,712,0.775,2465,2016,17
895,Temple,2018-19,33,23,10,0.697,6700,873,1998,0.437,626,1250,0.501,247,748,0.33,472,649,0.727,2465,2018,19
896,Houston Baptist,2018-19,30,12,18,0.4,6126,865,1896,0.456,665,1308,0.508,200,588,0.34,535,793,0.675,2465,2018,19
897,Ohio,2012-13,34,24,10,0.706,6850,889,1908,0.466,621,1144,0.543,268,764,0.351,418,598,0.699,2464,2012,13
898,Hofstra,2017-18,31,19,12,0.613,6225,868,1868,0.465,608,1175,0.517,260,693,0.375,468,686,0.682,2464,2017,18
899,Winthrop,2017-18,31,19,12,0.613,6200,859,1803,0.476,563,1011,0.557,296,792,0.374,450,623,0.722,2464,2017,18
900,Lamar,2010-11,30,13,17,0.433,6000,846,1961,0.431,612,1311,0.467,234,650,0.36,537,782,0.687,2463,2010,11
,,,,,,,,School,School,School,School,School,School,School,School,School,School,School,School,School,,
,Schl,Season,G,W,L,W-L%,MP,FG,FGA,FG%,2P,2PA,2P%,3P,3PA,3P%,FT,FTA,FT%,PTS,Season,
901,Northern Ill.,2015-16,34,21,13,0.618,6850,842,1970,0.427,604,1289,0.469,238,681,0.349,541,791,0.684,2463,2015,16
902,Saint Mary's,2018-19,34,22,12,0.647,6825,899,1905,0.472,646,1235,0.523,253,670,0.378,412,555,0.742,2463,2018,19
903,NW St.,2010-11,32,18,14,0.563,6501,832,1877,0.443,621,1265,0.491,211,612,0.345,587,922,0.637,2462,2010,11
904,Tennessee Tech,2010-11,33,20,13,0.606,6675,890,1863,0.478,738,1426,0.518,152,437,0.348,530,799,0.663,2462,2010,11
905,Buffalo,2014-15,33,23,10,0.697,6600,837,1922,0.435,638,1339,0.476,199,583,0.341,589,819,0.719,2462,2014,15
906,Ohio State,2015-16,35,21,14,0.6,7100,876,1995,0.439,657,1340,0.49,219,655,0.334,491,718,0.684,2462,2015,16
907,Nevada,2011-12,35,28,7,0.8,7100,842,1871,0.45,606,1229,0.493,236,642,0.368,541,832,0.65,2461,2011,12
908,Youngstown St.,2013-14,32,15,17,0.469,6526,836,1822,0.459,587,1110,0.529,249,712,0.35,540,735,0.735,2461,2013,14
909,Idaho,2013-14,34,16,18,0.471,6875,833,1865,0.447,617,1257,0.491,216,608,0.355,579,842,0.688,2461,2013,14
910,Illinois State,2012-13,33,18,15,0.545,6650,871,1914,0.455,629,1217,0.517,242,697,0.347,476,658,0.723,2460,2012,13
911,Wichita State,2014-15,35,30,5,0.857,7050,860,1933,0.445,621,1263,0.492,239,670,0.357,501,715,0.701,2460,2014,15
912,SE Missouri St,2016-17,33,15,18,0.455,6650,852,1897,0.449,589,1181,0.499,263,716,0.367,493,664,0.742,2460,2016,17
913,Eastern Wash.,2018-19,34,16,18,0.471,6895,876,2040,0.429,566,1154,0.49,310,886,0.35,398,546,0.729,2460,2018,19
914,Detroit,2010-11,33,17,16,0.515,6700,849,1832,0.463,681,1355,0.503,168,477,0.352,593,863,0.687,2459,2010,11
915,Middle Tenn.,2011-12,34,27,7,0.794,6850,882,1782,0.495,719,1337,0.538,163,445,0.366,532,838,0.635,2459,2011,12
916,St. Bonaventure,2016-17,32,20,12,0.625,6450,825,1864,0.443,624,1287,0.485,201,577,0.348,608,791,0.769,2459,2016,17
917,Fresno State,2017-18,32,21,11,0.656,6475,885,1805,0.49,669,1257,0.532,216,548,0.394,473,682,0.694,2459,2017,18
918,Coastal Caro.,2013-14,34,21,13,0.618,6873,861,1969,0.437,649,1341,0.484,212,628,0.338,524,758,0.691,2458,2013,14
919,Little Rock,2010-11,36,19,17,0.528,7275,825,1938,0.426,583,1323,0.441,242,615,0.393,565,819,0.69,2457,2010,11
920,Colorado,2013-14,35,23,12,0.657,7075,814,1871,0.435,633,1302,0.486,181,569,0.318,648,903,0.718,2457,2013,14
921,Akron,2011-12,34,22,12,0.647,6850,868,1879,0.462,661,1319,0.501,207,560,0.37,513,741,0.692,2456,2011,12
922,Temple,2012-13,34,24,10,0.706,6800,851,1986,0.428,608,1246,0.488,243,740,0.328,511,707,0.723,2456,2012,13
923,Nebraska,2015-16,34,16,18,0.471,6850,883,1976,0.447,663,1342,0.494,220,634,0.347,470,644,0.73,2456,2015,16
924,UMass-Lowell,2018-19,32,15,17,0.469,6450,875,1852,0.472,629,1131,0.556,246,721,0.341,460,639,0.72,2456,2018,19
925,Oakland,2013-14,33,13,20,0.394,6672,821,1890,0.434,542,1136,0.477,279,754,0.37,534,732,0.73,2455,2013,14
926,Jackson State,2015-16,36,20,16,0.556,7325,898,2208,0.407,655,1427,0.459,243,781,0.311,416,659,0.631,2455,2015,16
927,La.-Monroe,2014-15,38,24,14,0.632,7700,923,2162,0.427,731,1528,0.478,192,634,0.303,416,583,0.714,2454,2014,15
928,Colorado State,2014-15,34,27,7,0.794,6826,837,1901,0.44,592,1202,0.493,245,699,0.351,535,794,0.674,2454,2014,15
929,Drexel,2017-18,33,13,20,0.394,6700,880,1994,0.441,653,1295,0.504,227,699,0.325,467,646,0.723,2454,2017,18
930,Albany (NY),2011-12,34,19,15,0.559,6825,842,1889,0.446,597,1216,0.491,245,673,0.364,524,694,0.755,2453,2011,12
931,Charleston,2018-19,33,24,9,0.727,6650,878,1818,0.483,651,1151,0.566,227,667,0.34,470,615,0.764,2453,2018,19
932,Illinois,2015-16,34,15,19,0.441,6975,861,1993,0.432,584,1229,0.475,277,764,0.363,453,607,0.746,2452,2015,16
933,Cal St Fullerton,2012-13,32,14,18,0.438,6400,855,1819,0.47,589,1115,0.528,266,704,0.378,475,627,0.758,2451,2012,13
934,La Salle,2012-13,34,24,10,0.706,6848,871,1931,0.451,609,1236,0.493,262,695,0.377,446,605,0.737,2450,2012,13
935,Notre Dame,2012-13,35,25,10,0.714,7199,892,1929,0.462,664,1312,0.506,228,617,0.37,438,618,0.709,2450,2012,13
936,Oakland,2014-15,33,16,17,0.485,6749,857,1854,0.462,598,1138,0.525,259,716,0.362,477,695,0.686,2450,2014,15
937,Belmont,2014-15,33,22,11,0.667,6602,858,1803,0.476,529,937,0.565,329,866,0.38,405,585,0.692,2450,2014,15
938,Richmond,2015-16,32,16,16,0.5,6475,890,1848,0.482,650,1174,0.554,240,674,0.356,430,652,0.66,2450,2015,16
939,Texas,2017-18,34,19,15,0.559,7050,882,2010,0.439,637,1244,0.512,245,766,0.32,441,663,0.665,2450,2017,18
940,St. Francis (PA),2017-18,31,18,13,0.581,6300,860,1845,0.466,610,1175,0.519,250,670,0.373,480,630,0.762,2450,2017,18
941,Northern Colo.,2018-19,32,21,11,0.656,6477,849,1837,0.462,542,988,0.549,307,849,0.362,445,633,0.703,2450,2018,19
942,Utah State,2010-11,34,30,4,0.882,6850,840,1788,0.47,634,1226,0.517,206,562,0.367,563,764,0.737,2449,2010,11
943,Virginia,2013-14,37,30,7,0.811,7428,855,1884,0.454,649,1325,0.49,206,559,0.369,533,792,0.673,2449,2013,14
944,Minnesota,2014-15,33,18,15,0.545,6651,890,1924,0.463,647,1286,0.503,243,638,0.381,426,634,0.672,2449,2014,15
945,Saint Mary's,2016-17,34,29,5,0.853,6800,892,1797,0.496,599,1053,0.569,293,744,0.394,372,499,0.745,2449,2016,17
946,Miami (OH),2017-18,34,16,18,0.471,6950,886,2006,0.442,585,1128,0.519,301,878,0.343,376,548,0.686,2449,2017,18
947,Howard,2017-18,33,10,23,0.303,6724,847,1997,0.424,579,1225,0.473,268,772,0.347,487,688,0.708,2449,2017,18
948,VCU,2011-12,36,29,7,0.806,7250,837,2040,0.41,570,1240,0.46,267,800,0.334,507,740,0.685,2448,2011,12
949,Michigan State,2012-13,36,27,9,0.75,7199,882,1921,0.459,705,1398,0.504,177,523,0.338,507,710,0.714,2448,2012,13
950,Bucknell,2015-16,31,17,14,0.548,6324,831,1788,0.465,598,1149,0.52,233,639,0.365,553,774,0.714,2448,2015,16
951,Niagara,2016-17,33,10,23,0.303,6675,846,2035,0.416,602,1368,0.44,244,667,0.366,512,683,0.75,2448,2016,17
952,Wagner,2017-18,33,23,10,0.697,6625,839,1963,0.427,570,1194,0.477,269,769,0.35,501,705,0.711,2448,2017,18
953,Alabama,2018-19,34,18,16,0.529,6825,856,1945,0.44,612,1227,0.499,244,718,0.34,492,739,0.666,2448,2018,19
954,Fresno State,2018-19,32,23,9,0.719,6425,847,1866,0.454,505,969,0.521,342,897,0.381,412,572,0.72,2448,2018,19
955,Robert Morris,2018-19,35,18,17,0.514,7100,861,1991,0.432,581,1202,0.483,280,789,0.355,446,638,0.699,2448,2018,19
956,George Washington,2016-17,35,20,15,0.571,7000,821,1938,0.424,545,1195,0.456,276,743,0.371,529,710,0.745,2447,2016,17
957,Towson,2016-17,33,20,13,0.606,6675,850,1900,0.447,695,1401,0.496,155,499,0.311,592,868,0.682,2447,2016,17
958,McNeese State,2010-11,33,21,12,0.636,6675,831,1904,0.436,605,1264,0.479,226,640,0.353,558,749,0.745,2446,2010,11
959,St. Joseph's,2011-12,34,20,14,0.588,6925,876,1862,0.47,650,1240,0.524,226,622,0.363,468,676,0.692,2446,2011,12
960,SE Missouri St,2012-13,33,17,16,0.515,6625,880,1876,0.469,624,1232,0.506,256,644,0.398,430,614,0.7,2446,2012,13
961,Mercer,2015-16,34,19,15,0.559,6950,871,1958,0.445,661,1346,0.491,210,612,0.343,494,676,0.731,2446,2015,16
962,Mt. St. Mary's,2016-17,36,20,16,0.556,7225,877,1977,0.444,616,1247,0.494,261,730,0.358,431,640,0.673,2446,2016,17
963,Towson,2017-18,32,18,14,0.563,6500,889,1905,0.467,679,1323,0.513,210,582,0.361,458,667,0.687,2446,2017,18
964,Missouri State,2010-11,35,26,9,0.743,7000,842,1858,0.453,600,1214,0.494,242,644,0.376,518,710,0.73,2444,2010,11
965,Oakland,2012-13,33,16,17,0.485,6650,823,1886,0.436,584,1213,0.481,239,673,0.355,559,790,0.708,2444,2012,13
966,Jacksonville,2015-16,32,16,16,0.5,6450,866,1985,0.436,588,1270,0.463,278,715,0.389,434,640,0.678,2444,2015,16
967,Florida State,2011-12,35,25,10,0.714,7100,877,1923,0.456,661,1312,0.504,216,611,0.354,473,669,0.707,2443,2011,12
968,Texas-Arlington,2013-14,32,15,17,0.469,6520,815,1865,0.437,556,1117,0.498,259,748,0.346,554,785,0.706,2443,2013,14
969,South Dakota,2015-16,32,14,18,0.438,6525,912,1954,0.467,711,1389,0.512,201,565,0.356,418,596,0.701,2443,2015,16
970,New Mexico,2018-19,32,14,18,0.438,6400,814,1927,0.422,522,1083,0.482,292,844,0.346,523,745,0.702,2443,2018,19
971,Xavier,2013-14,34,21,13,0.618,6850,869,1850,0.47,695,1350,0.515,174,500,0.348,530,770,0.688,2442,2013,14
972,Seton Hall,2013-14,34,17,17,0.5,6925,816,1797,0.454,564,1093,0.516,252,704,0.358,558,774,0.721,2442,2013,14
973,Winthrop,2013-14,33,20,13,0.606,6725,821,1843,0.445,549,1157,0.475,272,686,0.397,528,741,0.713,2442,2013,14
974,Georgia State,2016-17,33,20,13,0.606,6625,885,1888,0.469,639,1198,0.533,246,690,0.357,426,658,0.647,2442,2016,17
975,Baylor,2018-19,34,20,14,0.588,6825,869,1966,0.442,595,1163,0.512,274,803,0.341,430,635,0.677,2442,2018,19
976,Northwestern,2010-11,34,20,14,0.588,6875,853,1897,0.45,534,1039,0.514,319,858,0.372,416,570,0.73,2441,2010,11
977,Houston Baptist,2016-17,31,17,14,0.548,6200,871,1924,0.453,676,1350,0.501,195,574,0.34,504,721,0.699,2441,2016,17
978,Boston College,2010-11,34,21,13,0.618,6801,856,1852,0.462,550,1050,0.524,306,802,0.382,422,583,0.724,2440,2010,11
979,Western Mich.,2010-11,34,21,13,0.618,6875,875,1974,0.443,680,1415,0.481,195,559,0.349,495,708,0.699,2440,2010,11
980,Samford,2015-16,33,14,19,0.424,6725,845,1857,0.455,668,1309,0.51,177,548,0.323,573,798,0.718,2440,2015,16
981,UC-Irvine,2017-18,35,18,17,0.514,7050,900,2061,0.437,680,1404,0.484,220,657,0.335,420,593,0.708,2440,2017,18
982,Radford,2018-19,33,22,11,0.667,6650,893,1938,0.461,608,1187,0.512,285,751,0.379,369,515,0.717,2440,2018,19
983,Florida,2018-19,36,20,16,0.556,7275,857,2015,0.425,566,1143,0.495,291,872,0.334,435,603,0.721,2440,2018,19
984,Illinois State,2011-12,35,21,14,0.6,7125,804,1832,0.439,507,1049,0.483,297,783,0.379,534,708,0.754,2439,2011,12
985,Valparaiso,2013-14,34,18,16,0.529,6875,813,1738,0.468,580,1114,0.521,233,624,0.373,580,790,0.734,2439,2013,14
986,Dayton,2014-15,36,27,9,0.75,7225,810,1755,0.462,571,1085,0.526,239,670,0.357,580,846,0.686,2439,2014,15
987,Southeastern LA,2017-18,34,22,12,0.647,6800,867,1911,0.454,617,1199,0.515,250,712,0.351,455,692,0.658,2439,2017,18
988,Portland State,2011-12,32,17,15,0.531,6423,846,1751,0.483,661,1220,0.542,185,531,0.348,561,761,0.737,2438,2011,12
989,Rice,2011-12,35,19,16,0.543,7025,859,1921,0.447,664,1348,0.493,195,573,0.34,525,768,0.684,2438,2011,12
990,Coastal Caro.,2014-15,34,24,10,0.706,6798,836,1899,0.44,608,1266,0.48,228,633,0.36,538,780,0.69,2438,2014,15
991,Maryland,2016-17,33,24,9,0.727,6625,827,1840,0.449,555,1083,0.512,272,757,0.359,512,732,0.699,2438,2016,17
992,Youngstown St.,2015-16,32,11,21,0.344,6525,870,2021,0.43,613,1317,0.465,257,704,0.365,440,619,0.711,2437,2015,16
993,Cal St Fullerton,2018-19,34,16,18,0.471,6925,868,1911,0.454,681,1322,0.515,187,589,0.317,514,726,0.708,2437,2018,19
994,San Diego State,2018-19,34,21,13,0.618,6800,845,1940,0.436,584,1219,0.479,261,721,0.362,486,679,0.716,2437,2018,19
995,Gonzaga,2011-12,33,26,7,0.788,6626,823,1740,0.473,608,1173,0.518,215,567,0.379,575,803,0.716,2436,2011,12
996,Tulane,2012-13,35,20,15,0.571,6999,789,1896,0.416,565,1255,0.45,224,641,0.349,634,872,0.727,2436,2012,13
997,Niagara,2012-13,33,19,14,0.576,6701,837,1982,0.422,596,1244,0.479,241,738,0.327,521,754,0.691,2436,2012,13
998,Temple,2014-15,37,26,11,0.703,7425,833,2149,0.388,598,1377,0.434,235,772,0.304,535,765,0.699,2436,2014,15
999,UConn,2018-19,33,16,17,0.485,6625,874,1959,0.446,622,1227,0.507,252,732,0.344,436,641,0.68,2436,2018,19
1000,Georgia,2016-17,34,19,15,0.559,6852,836,1903,0.439,661,1365,0.484,175,538,0.325,588,777,0.757,2435,2016,17
,,,,,,,,School,School,School,School,School,School,School,School,School,School,School,School,School,,
,Schl,Season,G,W,L,W-L%,MP,FG,FGA,FG%,2P,2PA,2P%,3P,3PA,3P%,FT,FTA,FT%,PTS,Season,
1001,Jacksonville St.,2016-17,35,20,15,0.571,7050,857,1869,0.459,599,1184,0.506,258,685,0.377,462,647,0.714,2434,2016,17
1002,Montana State,2017-18,32,13,19,0.406,6475,817,1929,0.424,560,1198,0.467,257,731,0.352,543,746,0.728,2434,2017,18
1003,Weber State,2017-18,31,20,11,0.645,6275,846,1722,0.491,566,1050,0.539,280,672,0.417,462,603,0.766,2434,2017,18
1004,St. Joseph's,2013-14,34,24,10,0.706,6825,840,1789,0.47,590,1129,0.523,250,660,0.379,503,780,0.645,2433,2013,14
1005,VMI,2018-19,32,11,21,0.344,6448,843,1974,0.427,520,1075,0.484,323,899,0.359,424,581,0.73,2433,2018,19
1006,Ohio State,2013-14,35,25,10,0.714,7049,843,1875,0.45,643,1258,0.511,200,617,0.324,546,793,0.689,2432,2013,14
1007,Arkansas State,2013-14,32,19,13,0.594,6576,797,1795,0.444,515,1058,0.487,282,737,0.383,556,766,0.726,2432,2013,14
1008,New Mexico,2015-16,32,17,15,0.531,6425,829,1782,0.465,633,1242,0.51,196,540,0.363,578,783,0.738,2432,2015,16
1009,Lehigh,2016-17,32,20,12,0.625,6475,857,1788,0.479,587,1099,0.534,270,689,0.392,448,580,0.772,2432,2016,17
1010,Morehead State,2018-19,33,13,20,0.394,6675,855,1993,0.429,595,1231,0.483,260,762,0.341,461,654,0.705,2431,2018,19
1011,Georgetown,2015-16,33,15,18,0.455,6675,820,1858,0.441,559,1088,0.514,261,770,0.339,529,704,0.751,2430,2015,16
1012,Colorado,2011-12,36,24,12,0.667,7225,835,1874,0.446,636,1302,0.488,199,572,0.348,560,810,0.691,2429,2011,12
1013,Eastern Mich.,2014-15,35,21,14,0.6,7075,806,1963,0.411,576,1221,0.472,230,742,0.31,587,817,0.718,2429,2014,15
1014,Elon,2015-16,32,16,16,0.5,6425,865,1942,0.445,562,1057,0.532,303,885,0.342,396,599,0.661,2429,2015,16
1015,UMass-Lowell,2016-17,31,11,20,0.355,6282,877,1825,0.481,619,1163,0.532,258,662,0.39,417,567,0.735,2429,2016,17
1016,Bowling Green,2017-18,32,16,16,0.5,6520,827,1963,0.421,586,1273,0.46,241,690,0.349,534,730,0.732,2429,2017,18
1017,Maryland,2018-19,34,23,11,0.676,6797,858,1909,0.449,611,1202,0.508,247,707,0.349,466,627,0.743,2429,2018,19
1018,Western Ky.,2018-19,34,20,14,0.588,6900,853,1910,0.447,654,1302,0.502,199,608,0.327,524,724,0.724,2429,2018,19
1019,N.C. Central,2018-19,34,18,16,0.529,6825,874,1922,0.455,653,1229,0.531,221,693,0.319,460,641,0.718,2429,2018,19
1020,Norfolk State,2013-14,34,19,15,0.559,6850,866,1864,0.465,679,1332,0.51,187,532,0.352,509,734,0.693,2428,2013,14
1021,Tx AM-CC,2015-16,33,25,8,0.758,6600,838,1918,0.437,623,1287,0.484,215,631,0.341,537,728,0.738,2428,2015,16
1022,Dayton,2016-17,32,24,8,0.75,6425,820,1763,0.465,562,1092,0.515,258,671,0.385,530,768,0.69,2428,2016,17
1023,Providence,2018-19,34,18,16,0.529,6925,835,1973,0.423,610,1283,0.475,225,690,0.326,533,771,0.691,2428,2018,19
1024,Rice,2015-16,32,12,20,0.375,6425,813,1798,0.452,585,1082,0.541,228,716,0.318,573,773,0.741,2427,2015,16
1025,North Dakota,2017-18,32,12,20,0.375,6527,863,1879,0.459,630,1194,0.528,233,685,0.34,468,663,0.706,2427,2017,18
1026,Yale,2018-19,30,22,8,0.733,6075,893,1812,0.493,663,1178,0.563,230,634,0.363,411,557,0.738,2427,2018,19
1027,Providence,2010-11,32,15,17,0.469,6425,854,2012,0.424,642,1339,0.479,212,673,0.315,506,756,0.669,2426,2010,11
1028,USC Upstate,2011-12,34,21,13,0.618,6825,888,2024,0.439,681,1409,0.483,207,615,0.337,443,695,0.637,2426,2011,12
1029,Southern Miss,2011-12,34,25,9,0.735,6975,819,1975,0.415,604,1374,0.44,215,601,0.358,573,779,0.736,2426,2011,12
1030,Youngstown St.,2012-13,34,18,16,0.529,6950,853,1979,0.431,608,1272,0.478,245,707,0.347,475,686,0.692,2426,2012,13
1031,Stony Brook,2013-14,34,23,11,0.676,6837,860,1900,0.453,676,1382,0.489,184,518,0.355,522,725,0.72,2426,2013,14
1032,Lafayette,2014-15,33,20,13,0.606,6625,872,1799,0.485,611,1159,0.527,261,640,0.408,421,549,0.767,2426,2014,15
1033,Fresno State,2016-17,33,20,13,0.606,6751,852,1872,0.455,643,1279,0.503,209,593,0.352,513,763,0.672,2426,2016,17
1034,Md.-East. Shore,2016-17,34,14,20,0.412,6901,854,2013,0.424,592,1248,0.474,262,765,0.342,456,668,0.683,2426,2016,17
1035,Illinois,2017-18,32,14,18,0.438,6475,856,1949,0.439,620,1244,0.498,236,705,0.335,478,653,0.732,2426,2017,18
1036,Ole Miss,2017-18,32,12,20,0.375,6500,841,1999,0.421,590,1211,0.487,251,788,0.319,493,675,0.73,2426,2017,18
1037,Grambling,2018-19,34,17,17,0.5,6850,834,1846,0.452,611,1293,0.473,223,553,0.403,535,781,0.685,2426,2018,19
1038,Gardner-Webb,2013-14,33,18,15,0.545,6801,848,1895,0.447,673,1379,0.488,175,516,0.339,554,807,0.686,2425,2013,14
1039,Oregon State,2013-14,32,16,16,0.5,6475,825,1689,0.488,648,1238,0.523,177,451,0.392,598,860,0.695,2425,2013,14
1040,UCSB,2017-18,32,23,9,0.719,6425,877,1891,0.464,620,1217,0.509,257,674,0.381,414,594,0.697,2425,2017,18
1041,Drexel,2018-19,32,13,19,0.406,6400,874,1900,0.46,637,1231,0.517,237,669,0.354,440,584,0.753,2425,2018,19
1042,New Mexico St.,2015-16,34,23,11,0.676,6900,887,1919,0.462,708,1382,0.512,179,537,0.333,471,696,0.677,2424,2015,16
1043,USC Upstate,2017-18,32,7,25,0.219,6450,881,2045,0.431,553,1093,0.506,328,952,0.345,334,460,0.726,2424,2017,18
1044,VMI,2012-13,31,14,17,0.452,6225,872,2011,0.434,590,1142,0.517,282,869,0.325,397,604,0.657,2423,2012,13
1045,LSU,2014-15,33,22,11,0.667,6750,892,1962,0.455,703,1404,0.501,189,558,0.339,450,658,0.684,2423,2014,15
1046,Oklahoma,2018-19,34,20,14,0.588,6824,883,1975,0.447,657,1321,0.497,226,654,0.346,431,618,0.697,2423,2018,19
1047,Radford,2017-18,36,23,13,0.639,7325,850,2000,0.425,573,1207,0.475,277,793,0.349,445,614,0.725,2422,2017,18
1048,Eastern Mich.,2013-14,37,22,15,0.595,7477,820,2004,0.409,633,1399,0.452,187,605,0.309,594,876,0.678,2421,2013,14
1049,St. Bonaventure,2013-14,33,18,15,0.545,6602,856,1881,0.455,701,1406,0.499,155,475,0.326,554,774,0.716,2421,2013,14
1050,Manhattan,2011-12,34,21,13,0.618,6850,815,1865,0.437,571,1189,0.48,244,676,0.361,546,750,0.728,2420,2011,12
1051,Valparaiso,2012-13,34,26,8,0.765,6824,823,1699,0.484,570,1019,0.559,253,680,0.372,521,713,0.731,2420,2012,13
1052,Seattle,2018-19,33,18,15,0.545,6650,852,1945,0.438,614,1303,0.471,238,642,0.371,478,668,0.716,2420,2018,19
1053,California,2011-12,34,24,10,0.706,6800,893,1878,0.476,737,1448,0.509,156,430,0.363,477,641,0.744,2419,2011,12
1054,Wright State,2013-14,36,21,15,0.583,7200,817,1793,0.456,597,1184,0.504,220,609,0.361,565,765,0.739,2419,2013,14
1055,Ohio State,2018-19,35,20,15,0.571,7025,839,1931,0.434,575,1157,0.497,264,774,0.341,477,650,0.734,2419,2018,19
1056,Morehead State,2014-15,34,17,17,0.5,6850,854,1930,0.442,634,1291,0.491,220,639,0.344,490,684,0.716,2418,2014,15
1057,St. Francis (NY),2014-15,35,23,12,0.657,7076,837,2005,0.417,642,1343,0.478,195,662,0.295,549,809,0.679,2418,2014,15
1058,Cincinnati,2015-16,33,22,11,0.667,6775,851,1980,0.43,599,1255,0.477,252,725,0.348,464,658,0.705,2418,2015,16
1059,Illinois State,2016-17,35,28,7,0.8,7025,865,1972,0.439,571,1175,0.486,294,797,0.369,394,593,0.664,2418,2016,17
1060,Cal St Fullerton,2011-12,31,21,10,0.677,6200,833,1763,0.472,567,1105,0.513,266,658,0.404,485,699,0.694,2417,2011,12
1061,Fairfield,2011-12,37,22,15,0.595,7401,884,1973,0.448,655,1311,0.5,229,662,0.346,420,645,0.651,2417,2011,12
1062,Maryland,2014-15,35,28,7,0.8,7050,781,1777,0.44,523,1090,0.48,258,687,0.376,597,790,0.756,2417,2014,15
1063,Seton Hall,2016-17,33,21,12,0.636,6675,872,1949,0.447,670,1351,0.496,202,598,0.338,471,733,0.643,2417,2016,17
1064,Western Mich.,2016-17,32,16,16,0.5,6425,863,1915,0.451,654,1352,0.484,209,563,0.371,482,685,0.704,2417,2016,17
1065,Arizona,2011-12,35,23,12,0.657,7050,795,1812,0.439,537,1129,0.476,258,683,0.378,568,806,0.705,2416,2011,12
1066,San Diego State,2011-12,34,26,8,0.765,6900,863,1903,0.453,666,1325,0.503,197,578,0.341,493,703,0.701,2416,2011,12
1067,Indiana State,2013-14,34,23,11,0.676,6800,814,1809,0.45,595,1180,0.504,219,629,0.348,569,787,0.723,2416,2013,14
1068,Tennessee Tech,2015-16,31,19,12,0.613,6226,792,1730,0.458,526,999,0.527,266,731,0.364,566,762,0.743,2416,2015,16
1069,Charleston,2016-17,35,25,10,0.714,7025,804,1862,0.432,584,1192,0.49,220,670,0.328,588,799,0.736,2416,2016,17
1070,Southern Utah,2017-18,32,13,19,0.406,6450,824,1887,0.437,571,1181,0.483,253,706,0.358,515,698,0.738,2416,2017,18
1071,Vermont,2011-12,36,24,12,0.667,7275,848,1914,0.443,657,1353,0.486,191,561,0.34,528,714,0.739,2415,2011,12
1072,George Washington,2013-14,33,24,9,0.727,6622,839,1812,0.463,652,1298,0.502,187,514,0.364,550,845,0.651,2415,2013,14
1073,VMI,2014-15,30,11,19,0.367,6100,829,2074,0.4,487,996,0.489,342,1078,0.317,415,607,0.684,2415,2014,15
1074,Youngstown St.,2018-19,32,12,20,0.375,6525,879,2057,0.427,576,1166,0.494,303,891,0.34,354,505,0.701,2415,2018,19
1075,Kansas State,2012-13,35,27,8,0.771,7000,872,2002,0.436,634,1344,0.472,238,658,0.362,432,631,0.685,2414,2012,13
1076,William & Mary,2014-15,33,20,13,0.606,6649,834,1726,0.483,541,990,0.546,293,736,0.398,453,617,0.734,2414,2014,15
1077,Robert Morris,2014-15,35,20,15,0.571,7050,854,1926,0.443,633,1336,0.474,221,590,0.375,485,684,0.709,2414,2014,15
1078,UCF,2016-17,36,24,12,0.667,7225,825,1898,0.435,562,1150,0.489,263,748,0.352,501,758,0.661,2414,2016,17
1079,Illinois,2010-11,34,20,14,0.588,6825,894,1910,0.468,662,1310,0.505,232,600,0.387,393,539,0.729,2413,2010,11
1080,Dayton,2010-11,36,22,14,0.611,7275,851,2079,0.409,608,1395,0.436,243,684,0.355,468,691,0.677,2413,2010,11
1081,Tennessee Tech,2017-18,33,19,14,0.576,6625,844,1924,0.439,602,1227,0.491,242,697,0.347,483,710,0.68,2413,2017,18
1082,Morehead State,2010-11,35,25,10,0.714,7069,851,1874,0.454,647,1273,0.508,204,601,0.339,506,751,0.674,2412,2010,11
1083,Cincinnati,2010-11,35,26,9,0.743,7025,848,1939,0.437,628,1288,0.488,220,651,0.338,496,742,0.668,2412,2010,11
1084,Murray State,2011-12,33,31,2,0.939,6650,811,1732,0.468,572,1128,0.507,239,604,0.396,551,761,0.724,2412,2011,12
1085,Idaho,2016-17,33,19,14,0.576,6750,809,1870,0.433,554,1176,0.471,255,694,0.367,539,746,0.723,2412,2016,17
1086,Stetson,2017-18,32,12,20,0.375,6450,907,2053,0.442,657,1327,0.495,250,726,0.344,348,518,0.672,2412,2017,18
1087,St. John's (NY),2017-18,33,16,17,0.485,6725,867,1999,0.434,635,1293,0.491,232,706,0.329,446,602,0.741,2412,2017,18
1088,Cal St Bakersfield,2018-19,34,18,16,0.529,6877,887,2092,0.424,666,1409,0.473,221,683,0.324,417,620,0.673,2412,2018,19
1089,UC-Irvine,2010-11,32,13,19,0.406,6550,798,1892,0.422,559,1217,0.459,239,675,0.354,576,784,0.735,2411,2010,11
1090,Air Force,2016-17,33,12,21,0.364,6676,817,1876,0.436,553,1148,0.482,264,728,0.363,513,715,0.717,2411,2016,17
1091,Bucknell,2011-12,35,25,10,0.714,7000,836,1813,0.461,630,1287,0.49,206,526,0.392,532,687,0.774,2410,2011,12
1092,Cleveland State,2013-14,33,21,12,0.636,6700,837,1786,0.469,597,1192,0.501,240,594,0.404,496,659,0.753,2410,2013,14
1093,Coastal Caro.,2015-16,33,21,12,0.636,6627,854,1909,0.447,610,1193,0.511,244,716,0.341,458,689,0.665,2410,2015,16
1094,Ball State,2017-18,32,19,13,0.594,6474,856,1895,0.452,611,1168,0.523,245,727,0.337,453,643,0.705,2410,2017,18
1095,Youngstown St.,2017-18,32,8,24,0.25,6450,902,2110,0.427,667,1398,0.477,235,712,0.33,371,583,0.636,2410,2017,18
1096,Western Ky.,2012-13,36,20,16,0.556,7225,837,1959,0.427,611,1250,0.489,226,709,0.319,509,755,0.674,2409,2012,13
1097,Penn State,2013-14,34,16,18,0.471,6876,820,1915,0.428,610,1256,0.486,210,659,0.319,559,754,0.741,2409,2013,14
1098,St. Bonaventure,2015-16,31,22,9,0.71,6251,812,1826,0.445,556,1139,0.488,256,687,0.373,529,684,0.773,2409,2015,16
1099,Davidson,2018-19,34,24,10,0.706,6825,852,1893,0.45,540,1011,0.534,312,882,0.354,393,525,0.749,2409,2018,19
1100,UMass,2012-13,33,21,12,0.636,6625,838,1932,0.434,603,1233,0.489,235,699,0.336,497,691,0.719,2408,2012,13
,,,,,,,,School,School,School,School,School,School,School,School,School,School,School,School,School,,
,Schl,Season,G,W,L,W-L%,MP,FG,FGA,FG%,2P,2PA,2P%,3P,3PA,3P%,FT,FTA,FT%,PTS,Season,
1101,Portland State,2015-16,31,13,18,0.419,6200,908,1904,0.477,741,1385,0.535,167,519,0.322,425,645,0.659,2408,2015,16
1102,Memphis,2017-18,34,21,13,0.618,6900,828,1832,0.452,627,1198,0.523,201,634,0.317,551,798,0.69,2408,2017,18
1103,High Point,2014-15,33,23,10,0.697,6850,862,1816,0.475,656,1281,0.512,206,535,0.385,477,649,0.735,2407,2014,15
1104,Texas State,2016-17,36,22,14,0.611,7275,865,1933,0.447,648,1276,0.508,217,657,0.33,460,696,0.661,2407,2016,17
1105,Longwood,2018-19,34,16,18,0.471,6876,803,1875,0.428,470,936,0.502,333,939,0.355,468,639,0.732,2407,2018,19
1106,Ga. Southern,2013-14,34,15,19,0.441,6876,840,1927,0.436,598,1211,0.494,242,716,0.338,484,731,0.662,2406,2013,14
1107,Dayton,2018-19,33,21,12,0.636,6674,902,1789,0.504,697,1172,0.595,205,617,0.332,397,575,0.69,2406,2018,19
1108,Middle Tenn.,2012-13,34,28,6,0.824,6850,848,1835,0.462,667,1355,0.492,181,480,0.377,528,759,0.696,2405,2012,13
1109,Ole Miss,2015-16,32,20,12,0.625,6450,796,1916,0.415,544,1170,0.465,252,746,0.338,561,791,0.709,2405,2015,16
1110,James Madison,2015-16,32,21,11,0.656,6525,830,1848,0.449,552,1073,0.514,278,775,0.359,467,682,0.685,2405,2015,16
1111,Cal St Bakersfield,2015-16,33,24,9,0.727,6650,875,1939,0.451,696,1415,0.492,179,524,0.342,476,726,0.656,2405,2015,16
1112,Jacksonville,2017-18,33,15,18,0.455,6725,897,1993,0.45,695,1392,0.499,202,601,0.336,409,622,0.658,2405,2017,18
1113,Minnesota,2017-18,32,15,17,0.469,6475,850,1971,0.431,632,1341,0.471,218,630,0.346,487,692,0.704,2405,2017,18
1114,Pitt,2016-17,33,16,17,0.485,6700,807,1825,0.442,544,1097,0.496,263,728,0.361,527,719,0.733,2404,2016,17
1115,Boise State,2016-17,32,20,12,0.625,6400,811,1802,0.45,558,1076,0.519,253,726,0.348,529,743,0.712,2404,2016,17
1116,St. John's (NY),2013-14,33,20,13,0.606,6725,867,1948,0.445,703,1478,0.476,164,470,0.349,505,722,0.699,2403,2013,14
1117,Texas Southern,2015-16,33,18,15,0.545,6605,848,1853,0.458,626,1196,0.523,222,657,0.338,485,769,0.631,2403,2015,16
1118,Elon,2016-17,32,18,14,0.563,6550,850,1911,0.445,542,1043,0.52,308,868,0.355,395,577,0.685,2403,2016,17
1119,Missouri State,2016-17,33,17,16,0.515,6725,838,1895,0.442,568,1151,0.493,270,744,0.363,457,652,0.701,2403,2016,17
1120,Cal Baptist,2018-19,31,16,15,0.516,6300,831,1859,0.447,544,1059,0.514,287,800,0.359,454,576,0.788,2403,2018,19
1121,Loyola Marymount,2011-12,34,21,13,0.618,6900,825,1936,0.426,604,1297,0.466,221,639,0.346,531,720,0.738,2402,2011,12
1122,Western Mich.,2017-18,32,17,15,0.531,6425,845,1926,0.439,612,1248,0.49,233,678,0.344,479,659,0.727,2402,2017,18
1123,Cleveland State,2017-18,35,12,23,0.343,7050,853,1965,0.434,559,1102,0.507,294,863,0.341,402,572,0.703,2402,2017,18
1124,Temple,2011-12,32,24,8,0.75,6525,861,1836,0.469,633,1262,0.502,228,574,0.397,451,627,0.719,2401,2011,12
1125,Western Mich.,2014-15,34,20,14,0.588,6875,819,1802,0.454,583,1153,0.506,236,649,0.364,527,750,0.703,2401,2014,15
1126,Georgia,2015-16,34,20,14,0.588,6850,799,1892,0.422,579,1294,0.447,220,598,0.368,583,823,0.708,2401,2015,16
1127,Kennesaw State,2016-17,32,14,18,0.438,6400,892,1932,0.462,686,1437,0.477,206,495,0.416,411,595,0.691,2401,2016,17
1128,Southern Miss,2017-18,34,16,18,0.471,6825,872,1958,0.445,618,1209,0.511,254,749,0.339,403,573,0.703,2401,2017,18
1129,Temple,2010-11,34,26,8,0.765,6875,868,1943,0.447,662,1360,0.487,206,583,0.353,458,656,0.698,2400,2010,11
1130,Northern Iowa,2012-13,36,21,15,0.583,7275,828,1869,0.443,548,1107,0.495,280,762,0.367,464,613,0.757,2400,2012,13
1131,Bowling Green,2015-16,34,16,18,0.471,6800,849,1913,0.444,646,1350,0.479,203,563,0.361,499,761,0.656,2400,2015,16
1132,Buffalo,2010-11,34,20,14,0.588,6850,879,1863,0.472,673,1315,0.512,206,548,0.376,435,668,0.651,2399,2010,11
1133,Wright State,2015-16,35,22,13,0.629,7025,856,1916,0.447,600,1229,0.488,256,687,0.373,431,621,0.694,2399,2015,16
1134,Norfolk State,2017-18,33,14,19,0.424,6625,858,1992,0.431,604,1285,0.47,254,707,0.359,429,639,0.671,2399,2017,18
1135,Missouri,2017-18,33,20,13,0.606,6651,794,1765,0.45,488,966,0.505,306,799,0.383,505,688,0.734,2399,2017,18
1136,Saint Louis,2018-19,36,23,13,0.639,7199,855,2052,0.417,650,1377,0.472,205,675,0.304,484,809,0.598,2399,2018,19
1137,Texas State,2012-13,34,12,22,0.353,6826,829,1974,0.42,602,1289,0.467,227,685,0.331,513,727,0.706,2398,2012,13
1138,Illinois,2018-19,33,12,21,0.364,6675,862,2001,0.431,603,1250,0.482,259,751,0.345,415,591,0.702,2398,2018,19
1139,Stanford,2012-13,34,19,15,0.559,6825,832,2002,0.416,595,1342,0.443,237,660,0.359,496,668,0.743,2397,2012,13
1140,Northeastern,2014-15,35,23,12,0.657,7075,838,1725,0.486,635,1199,0.53,203,526,0.386,518,713,0.727,2397,2014,15
1141,Longwood,2015-16,33,10,23,0.303,6650,860,1899,0.453,633,1249,0.507,227,650,0.349,450,636,0.708,2397,2015,16
1142,Drexel,2016-17,32,9,23,0.281,6501,865,1987,0.435,609,1246,0.489,256,741,0.345,411,617,0.666,2397,2016,17
1143,Kentucky,2012-13,33,21,12,0.636,6650,863,1815,0.475,679,1283,0.529,184,532,0.346,486,757,0.642,2396,2012,13
1144,Morehead State,2012-13,33,15,18,0.455,6700,842,1934,0.435,641,1308,0.49,201,626,0.321,511,739,0.691,2396,2012,13
1145,Iowa State,2010-11,32,16,16,0.5,6475,870,1993,0.437,595,1246,0.478,275,747,0.368,380,527,0.721,2395,2010,11
1146,Central Ark.,2016-17,32,8,24,0.25,6476,836,1910,0.438,606,1297,0.467,230,613,0.375,493,687,0.718,2395,2016,17
1147,Colgate,2017-18,33,19,14,0.576,6600,829,1897,0.437,520,1041,0.5,309,856,0.361,427,552,0.774,2394,2017,18
1148,Dayton,2015-16,33,25,8,0.758,6675,836,1836,0.455,615,1193,0.516,221,643,0.344,500,749,0.668,2393,2015,16
1149,Montana,2015-16,33,21,12,0.636,6650,841,1807,0.465,587,1127,0.521,254,680,0.374,457,657,0.696,2393,2015,16
1150,Colorado State,2018-19,32,12,20,0.375,6425,866,1818,0.476,607,1096,0.554,259,722,0.359,402,579,0.694,2393,2018,19
1151,Washington St.,2018-19,32,11,21,0.344,6400,833,1861,0.448,532,1033,0.515,301,828,0.364,426,564,0.755,2393,2018,19
1152,Davidson,2010-11,33,18,15,0.545,6600,819,1887,0.434,561,1137,0.493,258,750,0.344,496,677,0.733,2392,2010,11
1153,Elon,2013-14,32,18,14,0.563,6451,837,1789,0.468,581,1106,0.525,256,683,0.375,462,639,0.723,2392,2013,14
1154,Southern Miss,2018-19,33,20,13,0.606,6650,899,1929,0.466,624,1217,0.513,275,712,0.386,321,489,0.656,2392,2018,19
1155,San Jose State,2010-11,33,17,16,0.515,6800,808,1999,0.404,601,1443,0.416,207,556,0.372,568,753,0.754,2391,2010,11
1156,California,2010-11,33,18,15,0.545,6725,820,1779,0.461,651,1298,0.502,169,481,0.351,582,838,0.695,2391,2010,11
1157,Montana,2016-17,32,16,16,0.5,6450,843,1879,0.449,605,1212,0.499,238,667,0.357,467,621,0.752,2391,2016,17
1158,UIC,2018-19,32,16,16,0.5,6476,865,1883,0.459,562,1027,0.547,303,856,0.354,358,525,0.682,2391,2018,19
1159,Virginia Tech,2010-11,34,22,12,0.647,6875,834,1845,0.452,645,1273,0.507,189,572,0.33,533,751,0.71,2390,2010,11
1160,Boise State,2014-15,34,25,9,0.735,6925,831,1823,0.456,534,1065,0.501,297,758,0.392,431,591,0.729,2390,2014,15
1161,Texas Southern,2014-15,35,22,13,0.629,7152,818,1840,0.445,633,1266,0.5,185,574,0.322,569,861,0.661,2390,2014,15
1162,UT-Martin,2014-15,34,21,13,0.618,6870,855,1838,0.465,587,1157,0.507,268,681,0.394,412,582,0.708,2390,2014,15
1163,Wagner,2015-16,34,23,11,0.676,6826,856,2019,0.424,653,1402,0.466,203,617,0.329,474,665,0.713,2389,2015,16
1164,Saint Louis,2012-13,35,28,7,0.8,7050,808,1812,0.446,598,1195,0.5,210,617,0.34,562,798,0.704,2388,2012,13
1165,UC-Davis,2017-18,33,22,11,0.667,6800,834,1792,0.465,621,1220,0.509,213,572,0.372,505,705,0.716,2388,2017,18
1166,SC St.,2018-19,34,8,26,0.235,6875,811,1891,0.429,618,1309,0.472,193,582,0.332,573,772,0.742,2388,2018,19
1167,Bucknell,2010-11,34,25,9,0.735,6826,827,1855,0.446,593,1270,0.467,234,585,0.4,499,633,0.788,2387,2010,11
1168,Detroit,2016-17,31,8,23,0.258,6275,830,1867,0.445,579,1192,0.486,251,675,0.372,476,717,0.664,2387,2016,17
1169,Ohio,2016-17,31,20,11,0.645,6201,835,1837,0.455,550,1095,0.502,285,742,0.384,432,626,0.69,2387,2016,17
1170,North Texas,2015-16,32,12,20,0.375,6425,830,1838,0.452,643,1271,0.506,187,567,0.33,539,838,0.643,2386,2015,16
1171,Nebraska,2017-18,33,22,11,0.667,6625,820,1906,0.43,588,1236,0.476,232,670,0.346,514,716,0.718,2386,2017,18
1172,Louisiana Tech,2018-19,33,20,13,0.606,6674,840,1928,0.436,587,1172,0.501,253,756,0.335,453,690,0.657,2386,2018,19
1173,Marshall,2013-14,33,11,22,0.333,6650,837,1938,0.432,635,1283,0.495,202,655,0.308,509,818,0.622,2385,2013,14
1174,Norfolk State,2014-15,34,20,14,0.588,6900,850,1801,0.472,660,1252,0.527,190,549,0.346,495,751,0.659,2385,2014,15
1175,Illinois State,2014-15,35,22,13,0.629,7076,846,1945,0.435,634,1330,0.477,212,615,0.345,481,674,0.714,2385,2014,15
1176,San Diego,2017-18,34,20,14,0.588,6850,802,1775,0.452,513,981,0.523,289,794,0.364,492,692,0.711,2385,2017,18
1177,UCF,2018-19,33,24,9,0.727,6625,819,1763,0.465,590,1135,0.52,229,628,0.365,518,798,0.649,2385,2018,19
1178,Jacksonville,2018-19,32,12,20,0.375,6423,889,1953,0.455,676,1308,0.517,213,645,0.33,394,582,0.677,2385,2018,19
1179,Boston U.,2018-19,33,15,18,0.455,6625,922,1922,0.48,701,1283,0.546,221,639,0.346,320,468,0.684,2385,2018,19
1180,San Francisco,2010-11,34,19,15,0.559,6901,828,1889,0.438,601,1215,0.495,227,674,0.337,501,728,0.688,2384,2010,11
1181,UTSA,2010-11,34,20,14,0.588,6800,802,1871,0.429,568,1204,0.472,234,667,0.351,546,774,0.705,2384,2010,11
1182,Villanova,2010-11,33,21,12,0.636,6625,796,1819,0.438,586,1215,0.482,210,604,0.348,582,769,0.757,2384,2010,11
1183,Washington,2013-14,32,17,15,0.531,6450,835,1871,0.446,648,1319,0.491,187,552,0.339,527,695,0.758,2384,2013,14
1184,William & Mary,2015-16,31,20,11,0.645,6251,843,1755,0.48,602,1103,0.546,241,652,0.37,457,636,0.719,2384,2015,16
1185,New Orleans,2018-19,33,19,14,0.576,6726,862,1941,0.444,673,1375,0.489,189,566,0.334,471,681,0.692,2384,2018,19
1186,Charleston So.,2011-12,31,19,12,0.613,6225,835,1866,0.447,576,1185,0.486,259,681,0.38,454,658,0.69,2383,2011,12
1187,Tennessee,2016-17,32,16,16,0.5,6424,803,1903,0.422,614,1324,0.464,189,579,0.326,588,807,0.729,2383,2016,17
1188,Central Ark.,2018-19,33,14,19,0.424,6650,810,1903,0.426,534,1119,0.477,276,784,0.352,487,667,0.73,2383,2018,19
1189,UCLA,2010-11,34,23,11,0.676,6876,830,1824,0.455,657,1295,0.507,173,529,0.327,549,808,0.679,2382,2010,11
1190,TCU,2011-12,33,18,15,0.545,6725,819,1884,0.435,580,1216,0.477,239,668,0.358,505,731,0.691,2382,2011,12
1191,Marquette,2012-13,35,26,9,0.743,7100,842,1844,0.457,695,1347,0.516,147,497,0.296,551,755,0.73,2382,2012,13
1192,Akron,2014-15,35,21,14,0.6,7028,824,1982,0.416,496,1045,0.475,328,937,0.35,406,617,0.658,2382,2014,15
1193,Houston Baptist,2017-18,31,6,25,0.194,6250,860,2058,0.418,641,1381,0.464,219,677,0.323,443,710,0.624,2382,2017,18
1194,North Dakota St.,2017-18,32,15,17,0.469,6425,837,1783,0.469,543,1005,0.54,294,778,0.378,414,544,0.761,2382,2017,18
1195,Rider,2018-19,31,16,15,0.516,6225,847,1893,0.447,625,1242,0.503,222,651,0.341,465,755,0.616,2381,2018,19
1196,Richmond,2012-13,34,19,15,0.559,6926,776,1748,0.444,494,1001,0.494,282,747,0.378,546,756,0.722,2380,2012,13
1197,Auburn,2014-15,35,15,20,0.429,7075,760,1880,0.404,508,1153,0.441,252,727,0.347,606,910,0.666,2378,2014,15
1198,Miss. St.,2011-12,33,21,12,0.636,6750,854,1880,0.454,621,1227,0.506,233,653,0.357,436,614,0.71,2377,2011,12
1199,Oral Roberts,2014-15,34,19,15,0.559,6850,798,1859,0.429,593,1284,0.462,205,575,0.357,576,801,0.719,2377,2014,15
1200,Quinnipiac,2016-17,31,10,21,0.323,6250,848,2008,0.422,620,1308,0.474,228,700,0.326,453,663,0.683,2377,2016,17
,,,,,,,,School,School,School,School,School,School,School,School,School,School,School,School,School,,
,Schl,Season,G,W,L,W-L%,MP,FG,FGA,FG%,2P,2PA,2P%,3P,3PA,3P%,FT,FTA,FT%,PTS,Season,
1201,Tennessee,2010-11,34,19,15,0.559,6850,837,1941,0.431,662,1358,0.487,175,583,0.3,527,770,0.684,2376,2010,11
1202,Tennessee Tech,2013-14,33,17,16,0.515,6597,822,1810,0.454,637,1245,0.512,185,565,0.327,547,808,0.677,2376,2013,14
1203,Northeastern,2015-16,33,18,15,0.545,6825,793,1808,0.439,507,1038,0.488,286,770,0.371,504,704,0.716,2376,2015,16
1204,St. Peter's,2016-17,36,23,13,0.639,7250,825,1891,0.436,537,1136,0.473,288,755,0.381,438,625,0.701,2376,2016,17
1205,Albany (NY),2017-18,32,22,10,0.688,6402,839,1836,0.457,655,1334,0.491,184,502,0.367,513,680,0.754,2375,2017,18
1206,Saint Louis,2013-14,34,27,7,0.794,6875,829,1869,0.444,639,1268,0.504,190,601,0.316,526,755,0.697,2374,2013,14
1207,Norfolk State,2016-17,34,17,17,0.5,6900,827,1949,0.424,602,1286,0.468,225,663,0.339,495,727,0.681,2374,2016,17
1208,UMass,2017-18,33,13,20,0.394,6750,861,1918,0.449,568,1186,0.479,293,732,0.4,359,481,0.746,2374,2017,18
1209,Butler,2018-19,33,16,17,0.485,6650,861,1934,0.445,569,1107,0.514,292,827,0.353,360,488,0.738,2374,2018,19
1210,Western Mich.,2013-14,33,23,10,0.697,6701,779,1684,0.463,584,1091,0.535,195,593,0.329,620,856,0.724,2373,2013,14
1211,Eastern Ky.,2014-15,33,21,12,0.636,6650,818,1763,0.464,519,926,0.56,299,837,0.357,438,562,0.779,2373,2014,15
1212,Purdue,2014-15,34,21,13,0.618,6876,827,1840,0.449,632,1243,0.508,195,597,0.327,524,767,0.683,2373,2014,15
1213,Wisconsin,2015-16,35,22,13,0.629,7050,816,1917,0.426,587,1261,0.466,229,656,0.349,512,728,0.703,2373,2015,16
1214,Bryant,2016-17,32,12,20,0.375,6575,839,1917,0.438,602,1216,0.495,237,701,0.338,458,636,0.72,2373,2016,17
1215,Omaha,2017-18,31,9,22,0.29,6300,877,1913,0.458,623,1219,0.511,254,694,0.366,365,517,0.706,2373,2017,18
1216,LIU,2018-19,32,16,16,0.5,6418,822,1880,0.437,545,1067,0.511,277,813,0.341,452,643,0.703,2373,2018,19
1217,Iowa,2014-15,34,22,12,0.647,6850,821,1905,0.431,629,1329,0.473,192,576,0.333,538,723,0.744,2372,2014,15
1218,Idaho,2015-16,34,21,13,0.618,6825,800,1812,0.442,577,1221,0.473,223,591,0.377,549,774,0.709,2372,2015,16
1219,Southern Miss,2010-11,32,22,10,0.688,6425,825,1821,0.453,653,1353,0.483,172,468,0.368,549,752,0.73,2371,2010,11
1220,Bradley,2012-13,35,18,17,0.514,7050,876,2006,0.437,691,1426,0.485,185,580,0.319,434,600,0.723,2371,2012,13
1221,Oklahoma State,2012-13,33,24,9,0.727,6725,814,1854,0.439,631,1274,0.495,183,580,0.316,560,751,0.746,2371,2012,13
1222,Mercer,2012-13,36,24,12,0.667,7250,807,1856,0.435,542,1110,0.488,265,746,0.355,492,653,0.753,2371,2012,13
1223,UMass,2016-17,33,15,18,0.455,6600,847,1939,0.437,613,1150,0.533,234,789,0.297,443,671,0.66,2371,2016,17
1224,George Mason,2017-18,33,16,17,0.485,6725,841,1949,0.432,611,1244,0.491,230,705,0.326,459,619,0.742,2371,2017,18
1225,St. Joseph's,2017-18,32,16,16,0.5,6450,826,1953,0.423,571,1196,0.477,255,757,0.337,464,675,0.687,2371,2017,18
1226,Campbell,2011-12,32,17,15,0.531,6426,846,1748,0.484,677,1296,0.522,169,452,0.374,509,761,0.669,2370,2011,12
1227,Providence,2014-15,34,22,12,0.647,6850,828,1889,0.438,657,1343,0.489,171,546,0.313,543,768,0.707,2370,2014,15
1228,Morehead State,2016-17,30,14,16,0.467,6075,878,1906,0.461,659,1338,0.493,219,568,0.386,395,544,0.726,2370,2016,17
1229,Syracuse,2018-19,34,20,14,0.588,6824,808,1907,0.424,534,1083,0.493,274,824,0.333,480,701,0.685,2370,2018,19
1230,Dayton,2011-12,33,20,13,0.606,6700,814,1860,0.438,557,1110,0.502,257,750,0.343,484,623,0.777,2369,2011,12
1231,Akron,2012-13,33,26,7,0.788,6700,852,1874,0.455,623,1185,0.526,229,689,0.332,436,678,0.643,2369,2012,13
1232,Montana State,2015-16,31,14,17,0.452,6226,831,1916,0.434,534,1119,0.477,297,797,0.373,410,598,0.686,2369,2015,16
1233,UAB,2016-17,33,17,16,0.515,6650,835,1809,0.462,632,1226,0.515,203,583,0.348,496,674,0.736,2369,2016,17
1234,Georgetown,2016-17,32,14,18,0.438,6450,808,1752,0.461,602,1162,0.518,206,590,0.349,547,746,0.733,2369,2016,17
1235,Arkansas State,2017-18,32,11,21,0.344,6449,841,1910,0.44,605,1215,0.498,236,695,0.34,451,628,0.718,2369,2017,18
1236,Old Dominion,2011-12,36,22,14,0.611,7349,844,2082,0.405,637,1435,0.444,207,647,0.32,473,766,0.617,2368,2011,12
1237,NJIT,2014-15,33,21,12,0.636,6600,808,1768,0.457,529,1026,0.516,279,742,0.376,473,680,0.696,2368,2014,15
1238,Washington,2016-17,31,9,22,0.29,6226,874,1949,0.448,648,1310,0.495,226,639,0.354,394,602,0.654,2368,2016,17
1239,Penn State,2016-17,33,15,18,0.455,6725,825,1989,0.415,595,1310,0.454,230,679,0.339,487,654,0.745,2367,2016,17
1240,Memphis,2016-17,32,19,13,0.594,6450,852,1926,0.442,671,1313,0.511,181,613,0.295,482,706,0.683,2367,2016,17
1241,Rice,2018-19,32,13,19,0.406,6525,795,1867,0.426,518,1070,0.484,277,797,0.348,500,729,0.686,2367,2018,19
1242,Valparaiso,2014-15,34,28,6,0.824,6826,837,1836,0.456,601,1216,0.494,236,620,0.381,456,676,0.675,2366,2014,15
1243,Tennessee Tech,2011-12,33,19,14,0.576,6650,823,1772,0.464,644,1261,0.511,179,511,0.35,540,758,0.712,2365,2011,12
1244,Longwood,2010-11,31,12,19,0.387,6200,849,1866,0.455,613,1204,0.509,236,662,0.356,430,615,0.699,2364,2010,11
1245,New Mexico St.,2010-11,33,16,17,0.485,6700,793,1780,0.446,609,1226,0.497,184,554,0.332,594,879,0.676,2364,2010,11
1246,IUPUI,2010-11,33,19,14,0.576,6650,854,1806,0.473,652,1239,0.526,202,567,0.356,454,580,0.783,2364,2010,11
1247,Northern Colo.,2013-14,32,18,14,0.563,6476,864,1752,0.493,674,1260,0.535,190,492,0.386,446,651,0.685,2364,2013,14
1248,Illinois State,2017-18,33,18,15,0.545,6750,813,1917,0.424,512,1034,0.495,301,883,0.341,437,640,0.683,2364,2017,18
1249,Quinnipiac,2017-18,33,12,21,0.364,6775,787,1864,0.422,484,971,0.498,303,893,0.339,487,690,0.706,2364,2017,18
1250,Stony Brook,2018-19,33,24,9,0.727,6675,815,1937,0.421,582,1222,0.476,233,715,0.326,501,695,0.721,2364,2018,19
1251,Boise State,2018-19,33,13,20,0.394,6650,845,1801,0.469,593,1086,0.546,252,715,0.352,422,584,0.723,2364,2018,19
1252,UNLV,2010-11,33,24,9,0.727,6625,842,1836,0.459,658,1278,0.515,184,558,0.33,495,718,0.689,2363,2010,11
1253,Hampton,2015-16,32,21,11,0.656,6525,810,1967,0.412,604,1289,0.469,206,678,0.304,537,815,0.659,2363,2015,16
1254,Charleston So.,2010-11,32,16,16,0.5,6425,849,1898,0.447,641,1325,0.484,208,573,0.363,456,604,0.755,2362,2010,11
1255,Prairie View,2013-14,34,11,23,0.324,7026,813,1949,0.417,590,1298,0.455,223,651,0.343,513,791,0.649,2362,2013,14
1256,San Diego,2013-14,35,18,17,0.514,6999,816,1815,0.45,591,1215,0.486,225,600,0.375,505,726,0.696,2362,2013,14
1257,Eastern Wash.,2013-14,31,15,16,0.484,6225,813,1791,0.454,562,1114,0.504,251,677,0.371,485,700,0.693,2362,2013,14
1258,Charlotte,2014-15,32,14,18,0.438,6600,858,1853,0.463,657,1320,0.498,201,533,0.377,445,685,0.65,2362,2014,15
1259,LIU,2015-16,31,16,15,0.516,6275,813,1884,0.432,634,1282,0.495,179,602,0.297,557,779,0.715,2362,2015,16
1260,San Francisco,2016-17,33,20,13,0.606,6600,868,1934,0.449,569,1079,0.527,299,855,0.35,327,514,0.636,2362,2016,17
1261,Davidson,2016-17,32,17,15,0.531,6450,814,1861,0.437,522,1005,0.519,292,856,0.341,442,587,0.753,2362,2016,17
1262,Charleston So.,2012-13,32,19,13,0.594,6450,818,1937,0.422,521,1111,0.469,297,826,0.36,428,605,0.707,2361,2012,13
1263,Kent State,2015-16,32,19,13,0.594,6450,834,1871,0.446,649,1307,0.497,185,564,0.328,508,744,0.683,2361,2015,16
1264,Grambling,2016-17,33,16,17,0.485,6700,841,1943,0.433,657,1362,0.482,184,581,0.317,495,747,0.663,2361,2016,17
1265,Miami (FL),2017-18,32,22,10,0.688,6450,875,1881,0.465,628,1203,0.522,247,678,0.364,362,547,0.662,2361,2017,18
1266,Tennessee State,2012-13,33,18,15,0.545,6650,800,1822,0.439,594,1211,0.491,206,611,0.337,554,741,0.748,2360,2012,13
1267,Arizona State,2014-15,34,18,16,0.529,6924,809,1818,0.445,578,1158,0.499,231,660,0.35,511,766,0.667,2360,2014,15
1268,Sacred Heart,2014-15,32,15,17,0.469,6575,874,1911,0.457,705,1382,0.51,169,529,0.319,443,685,0.647,2360,2014,15
1269,Southern Ill.,2015-16,32,22,10,0.688,6450,828,1827,0.453,616,1209,0.51,212,618,0.343,492,718,0.685,2360,2015,16
1270,Southern,2016-17,33,15,18,0.455,6625,825,1887,0.437,662,1377,0.481,163,510,0.32,547,786,0.696,2360,2016,17
1271,Savannah State,2018-19,31,11,20,0.355,6225,825,2080,0.397,474,881,0.538,351,1199,0.293,359,531,0.676,2360,2018,19
1272,Abilene Christ.,2017-18,32,16,16,0.5,6450,870,1874,0.464,657,1218,0.539,213,656,0.325,406,579,0.701,2359,2017,18
1273,Arkansas State,2018-19,32,13,19,0.406,6550,796,1904,0.418,559,1195,0.468,237,709,0.334,530,721,0.735,2359,2018,19
1274,Louisiana Tech,2011-12,34,18,16,0.529,6900,849,2013,0.422,591,1236,0.478,258,777,0.332,402,620,0.648,2358,2011,12
1275,Arkansas,2012-13,32,19,13,0.594,6450,852,1960,0.435,660,1321,0.5,192,639,0.3,462,687,0.672,2358,2012,13
1276,Towson,2015-16,33,20,13,0.606,6650,805,1888,0.426,623,1314,0.474,182,574,0.317,566,840,0.674,2358,2015,16
1277,Houston,2016-17,32,21,11,0.656,6425,850,1902,0.447,582,1221,0.477,268,681,0.394,390,544,0.717,2358,2016,17
1278,San Francisco,2018-19,31,21,10,0.677,6250,864,1851,0.467,606,1124,0.539,258,727,0.355,372,568,0.655,2358,2018,19
1279,UAB,2012-13,33,16,17,0.485,6625,857,1980,0.433,638,1325,0.482,219,655,0.334,424,586,0.724,2357,2012,13
1280,Oral Roberts,2013-14,33,17,16,0.515,6650,831,1806,0.46,674,1359,0.496,157,447,0.351,538,747,0.72,2357,2013,14
1281,Hawaii,2011-12,32,16,16,0.5,6475,835,1811,0.461,673,1310,0.514,162,501,0.323,524,786,0.667,2356,2011,12
1282,San Diego State,2012-13,34,23,11,0.676,6824,839,1916,0.438,637,1298,0.491,202,618,0.327,476,697,0.683,2356,2012,13
1283,Winthrop,2014-15,32,19,13,0.594,6500,812,1809,0.449,561,1109,0.506,251,700,0.359,481,664,0.724,2356,2014,15
1284,Oral Roberts,2015-16,31,14,17,0.452,6225,832,1821,0.457,638,1307,0.488,194,514,0.377,498,665,0.749,2356,2015,16
1285,Tulsa,2015-16,32,20,12,0.625,6450,821,1849,0.444,602,1178,0.511,219,671,0.326,495,731,0.677,2356,2015,16
1286,UT-Martin,2018-19,31,12,19,0.387,6244,854,1915,0.446,604,1189,0.508,250,726,0.344,398,528,0.754,2356,2018,19
1287,James Madison,2010-11,33,21,12,0.636,6625,830,1812,0.458,631,1285,0.491,199,527,0.378,496,698,0.711,2355,2010,11
1288,New Mexico St.,2012-13,35,24,11,0.686,7050,832,1828,0.455,695,1390,0.5,137,438,0.313,554,845,0.656,2355,2012,13
1289,New Mexico,2012-13,35,29,6,0.829,7050,768,1815,0.423,547,1186,0.461,221,629,0.351,598,829,0.721,2355,2012,13
1290,UNLV,2013-14,33,20,13,0.606,6651,834,1905,0.438,639,1313,0.487,195,592,0.329,492,752,0.654,2355,2013,14
1291,Texas,2015-16,33,20,13,0.606,6650,814,1884,0.432,582,1203,0.484,232,681,0.341,495,743,0.666,2355,2015,16
1292,Bowling Green,2016-17,32,13,19,0.406,6475,832,1957,0.425,612,1313,0.466,220,644,0.342,471,706,0.667,2355,2016,17
1293,SE Missouri St,2017-18,31,14,17,0.452,6250,796,1729,0.46,507,991,0.512,289,738,0.392,474,650,0.729,2355,2017,18
1294,SC St.,2017-18,32,10,22,0.313,6450,829,1948,0.426,624,1334,0.468,205,614,0.334,492,706,0.697,2355,2017,18
1295,Brown,2018-19,32,20,12,0.625,6450,805,1818,0.443,550,1073,0.513,255,745,0.342,490,685,0.715,2355,2018,19
1296,George Washington,2014-15,35,22,13,0.629,7075,827,1887,0.438,635,1342,0.473,192,545,0.352,508,754,0.674,2354,2014,15
1297,Ga. Southern,2015-16,31,14,17,0.452,6251,781,1903,0.41,499,1069,0.467,282,834,0.338,509,728,0.699,2353,2015,16
1298,UMass,2015-16,32,14,18,0.438,6500,817,1903,0.429,583,1194,0.488,234,709,0.33,485,694,0.699,2353,2015,16
1299,Butler,2011-12,37,22,15,0.595,7476,823,2014,0.409,640,1363,0.47,183,651,0.281,523,806,0.649,2352,2011,12
1300,Delaware,2018-19,33,17,16,0.515,6796,830,1808,0.459,548,1062,0.516,282,746,0.378,410,564,0.727,2352,2018,19
,,,,,,,,School,School,School,School,School,School,School,School,School,School,School,School,School,,
,Schl,Season,G,W,L,W-L%,MP,FG,FGA,FG%,2P,2PA,2P%,3P,3PA,3P%,FT,FTA,FT%,PTS,Season,
1301,Evansville,2011-12,32,16,16,0.5,6575,801,1738,0.461,624,1285,0.486,177,453,0.391,572,749,0.764,2351,2011,12
1302,Bryant,2013-14,32,18,14,0.563,6452,840,1788,0.47,639,1186,0.539,201,602,0.334,470,669,0.703,2351,2013,14
1303,Cal St Fullerton,2016-17,32,17,15,0.531,6576,821,1850,0.444,625,1219,0.513,196,631,0.311,513,747,0.687,2351,2016,17
1304,Duquesne,2018-19,32,19,13,0.594,6475,810,1894,0.428,539,1053,0.512,271,841,0.322,460,663,0.694,2351,2018,19
1305,Drexel,2011-12,36,29,7,0.806,7200,801,1821,0.44,580,1237,0.469,221,584,0.378,527,711,0.741,2350,2011,12
1306,Tx AM-CC,2013-14,34,18,16,0.529,6824,837,1764,0.474,689,1359,0.507,148,405,0.365,528,796,0.663,2350,2013,14
1307,SMU,2014-15,34,27,7,0.794,6825,832,1750,0.475,687,1350,0.509,145,400,0.363,541,770,0.703,2350,2014,15
1308,Georgetown,2017-18,30,15,15,0.5,6175,800,1763,0.454,574,1145,0.501,226,618,0.366,524,676,0.775,2350,2017,18
1309,UCSB,2018-19,32,22,10,0.688,6450,825,1819,0.454,621,1225,0.507,204,594,0.343,496,693,0.716,2350,2018,19
1310,Lafayette,2012-13,34,19,15,0.559,6825,842,1842,0.457,566,1124,0.504,276,718,0.384,389,516,0.754,2349,2012,13
1311,Baylor,2014-15,34,24,10,0.706,6850,813,1874,0.434,577,1248,0.462,236,626,0.377,487,723,0.674,2349,2014,15
1312,Pepperdine,2015-16,32,18,14,0.563,6500,840,1861,0.451,678,1392,0.487,162,469,0.345,507,754,0.672,2349,2015,16
1313,Florida State,2010-11,34,23,11,0.676,6825,827,1903,0.435,615,1269,0.485,212,634,0.334,482,725,0.665,2348,2010,11
1314,Loyola (IL),2016-17,32,18,14,0.563,6498,852,1754,0.486,593,1089,0.545,259,665,0.389,385,543,0.709,2348,2016,17
1315,Colorado State,2013-14,32,16,16,0.5,6401,770,1798,0.428,600,1276,0.47,170,522,0.326,637,877,0.726,2347,2013,14
1316,Rutgers,2013-14,33,12,21,0.364,6600,823,1931,0.426,624,1338,0.466,199,593,0.336,502,711,0.706,2347,2013,14
1317,UTEP,2013-14,34,23,11,0.676,6850,797,1714,0.465,646,1257,0.514,151,457,0.33,602,880,0.684,2347,2013,14
1318,Montana,2014-15,33,20,13,0.606,6850,828,1786,0.464,554,1049,0.528,274,737,0.372,417,581,0.718,2347,2014,15
1319,Milwaukee,2016-17,35,11,24,0.314,7150,860,1949,0.441,588,1167,0.504,272,782,0.348,355,538,0.66,2347,2016,17
1320,Old Dominion,2017-18,32,25,7,0.781,6450,844,1888,0.447,616,1249,0.493,228,639,0.357,431,623,0.692,2347,2017,18
1321,West Virginia,2011-12,33,19,14,0.576,6775,838,1914,0.438,664,1331,0.499,174,583,0.298,496,739,0.671,2346,2011,12
1322,James Madison,2012-13,36,21,15,0.583,7250,818,1941,0.421,607,1313,0.462,211,628,0.336,499,714,0.699,2346,2012,13
1323,Hampton,2014-15,35,17,18,0.486,7025,796,1959,0.406,602,1321,0.456,194,638,0.304,560,859,0.652,2346,2014,15
1324,Butler,2014-15,34,23,11,0.676,6900,814,1882,0.433,622,1342,0.463,192,540,0.356,526,767,0.686,2346,2014,15
1325,Arkansas State,2016-17,32,20,12,0.625,6425,826,1792,0.461,606,1213,0.5,220,579,0.38,474,743,0.638,2346,2016,17
1326,Texas Tech,2016-17,32,18,14,0.563,6500,835,1776,0.47,623,1199,0.52,212,577,0.367,464,633,0.733,2346,2016,17
1327,Elon,2017-18,32,14,18,0.438,6600,842,1916,0.439,505,950,0.532,337,966,0.349,325,457,0.711,2346,2017,18
1328,Western Mich.,2012-13,35,22,13,0.629,7075,785,1816,0.432,597,1229,0.486,188,587,0.32,587,835,0.703,2345,2012,13
1329,Loyola Marymount,2013-14,32,13,19,0.406,6328,838,1922,0.436,697,1442,0.483,141,480,0.294,528,693,0.762,2345,2013,14
1330,Houston,2013-14,33,17,16,0.515,6625,833,1833,0.454,621,1255,0.495,212,578,0.367,467,700,0.667,2345,2013,14
1331,Colorado,2014-15,34,16,18,0.471,6899,812,1861,0.436,633,1326,0.477,179,535,0.335,542,760,0.713,2345,2014,15
1332,Arizona State,2015-16,32,15,17,0.469,6450,796,1919,0.415,542,1162,0.466,254,757,0.336,499,726,0.687,2345,2015,16
1333,St. Francis (NY),2018-19,33,17,16,0.515,6625,841,1989,0.423,571,1183,0.483,270,806,0.335,393,580,0.678,2345,2018,19
1334,Pacific,2012-13,35,22,13,0.629,7026,824,1839,0.448,599,1249,0.48,225,590,0.381,471,684,0.689,2344,2012,13
1335,Georgetown,2013-14,33,18,15,0.545,6650,801,1743,0.46,621,1200,0.518,180,543,0.331,562,780,0.721,2344,2013,14
1336,Southeastern LA,2015-16,33,12,21,0.364,6625,831,1833,0.453,590,1185,0.498,241,648,0.372,441,694,0.635,2344,2015,16
1337,VCU,2018-19,33,25,8,0.758,6650,820,1872,0.438,585,1101,0.531,235,771,0.305,469,669,0.701,2344,2018,19
1338,Kansas State,2011-12,33,22,11,0.667,6675,812,1849,0.439,629,1303,0.483,183,546,0.335,536,799,0.671,2343,2011,12
1339,Boise State,2012-13,32,21,11,0.656,6425,824,1790,0.46,575,1153,0.499,249,637,0.391,446,597,0.747,2343,2012,13
1340,Georgia,2013-14,34,20,14,0.588,6844,767,1740,0.441,600,1262,0.475,167,478,0.349,642,941,0.682,2343,2013,14
1341,Harvard,2013-14,32,27,5,0.844,6500,786,1691,0.465,602,1213,0.496,184,478,0.385,587,811,0.724,2343,2013,14
1342,St. John's (NY),2014-15,33,21,12,0.636,6625,835,1890,0.442,637,1321,0.482,198,569,0.348,475,687,0.691,2343,2014,15
1343,Florida A&M,2017-18,34,9,25,0.265,6925,831,1981,0.419,614,1365,0.45,217,616,0.352,464,641,0.724,2343,2017,18
1344,Utah,2018-19,31,17,14,0.548,6225,805,1735,0.464,507,929,0.546,298,806,0.37,435,616,0.706,2343,2018,19
1345,Texas Tech,2010-11,32,13,19,0.406,6450,824,1853,0.445,645,1362,0.474,179,491,0.365,515,706,0.729,2342,2010,11
1346,Sacramento St.,2014-15,33,21,12,0.636,6600,841,1729,0.486,633,1219,0.519,208,510,0.408,452,614,0.736,2342,2014,15
1347,New Hampshire,2015-16,33,20,13,0.606,6651,809,1944,0.416,587,1278,0.459,222,666,0.333,502,693,0.724,2342,2015,16
1348,Western Mich.,2015-16,32,13,19,0.406,6550,786,1824,0.431,589,1255,0.469,197,569,0.346,573,805,0.712,2342,2015,16
1349,Loyola (MD),2012-13,35,23,12,0.657,7101,826,1919,0.43,679,1427,0.476,147,492,0.299,542,786,0.69,2341,2012,13
1350,Cal St Northridge,2016-17,30,11,19,0.367,5999,806,1747,0.461,661,1332,0.496,145,415,0.349,584,801,0.729,2341,2016,17
1351,James Madison,2017-18,32,10,22,0.313,6550,812,1933,0.42,581,1238,0.469,231,695,0.332,486,667,0.729,2341,2017,18
1352,William & Mary,2013-14,32,20,12,0.625,6425,798,1676,0.476,517,971,0.532,281,705,0.399,463,667,0.694,2340,2013,14
1353,Santa Clara,2013-14,33,14,19,0.424,6626,788,1853,0.425,540,1175,0.46,248,678,0.366,516,704,0.733,2340,2013,14
1354,Georgetown,2014-15,33,22,11,0.667,6699,799,1753,0.456,598,1184,0.505,201,569,0.353,541,769,0.704,2340,2014,15
1355,UTSA,2011-12,32,18,14,0.563,6520,793,1775,0.447,521,1085,0.48,272,690,0.394,481,647,0.743,2339,2011,12
1356,Middle Tenn.,2013-14,33,24,9,0.727,6651,816,1795,0.455,638,1275,0.5,178,520,0.342,529,796,0.665,2339,2013,14
1357,Bucknell,2014-15,34,19,15,0.559,6900,800,1828,0.438,567,1223,0.464,233,605,0.385,506,726,0.697,2339,2014,15
1358,Boston U.,2016-17,32,18,14,0.563,6500,817,1844,0.443,543,1071,0.507,274,773,0.354,431,619,0.696,2339,2016,17
1359,Oregon State,2017-18,32,16,16,0.5,6500,830,1779,0.467,638,1196,0.533,192,583,0.329,487,688,0.708,2339,2017,18
1360,Clemson,2018-19,34,20,14,0.588,6800,833,1857,0.449,616,1196,0.515,217,661,0.328,456,623,0.732,2339,2018,19
1361,Michigan State,2010-11,34,19,15,0.559,6874,817,1894,0.431,597,1274,0.469,220,620,0.355,484,691,0.7,2338,2010,11
1362,Tennessee,2011-12,34,19,15,0.559,6925,809,1848,0.438,580,1199,0.484,229,649,0.353,491,699,0.702,2338,2011,12
1363,Delaware,2017-18,33,14,19,0.424,6650,859,1880,0.457,667,1296,0.515,192,584,0.329,428,657,0.651,2338,2017,18
1364,Maryland,2017-18,32,19,13,0.594,6425,811,1696,0.478,582,1079,0.539,229,617,0.371,487,645,0.755,2338,2017,18
1365,Minnesota,2012-13,34,21,13,0.618,6825,815,1838,0.443,631,1292,0.488,184,546,0.337,523,764,0.685,2337,2012,13
1366,Louisiana,2012-13,33,13,20,0.394,6675,827,1935,0.427,601,1272,0.472,226,663,0.341,457,681,0.671,2337,2012,13
1367,Utah State,2016-17,32,15,17,0.469,6425,828,1779,0.465,583,1133,0.515,245,646,0.379,436,624,0.699,2337,2016,17
1368,UConn,2011-12,34,20,14,0.588,6875,858,1900,0.452,673,1343,0.501,185,557,0.332,435,657,0.662,2336,2011,12
1369,Saint Louis,2011-12,34,26,8,0.765,6825,814,1813,0.449,576,1150,0.501,238,663,0.359,470,653,0.72,2336,2011,12
1370,Hawaii,2012-13,32,17,15,0.531,6425,836,1850,0.452,641,1281,0.5,195,569,0.343,469,683,0.687,2336,2012,13
1371,Hartford,2015-16,33,10,23,0.303,6725,777,1906,0.408,458,1004,0.456,319,902,0.354,463,619,0.748,2336,2015,16
1372,Monmouth,2017-18,31,11,20,0.355,6400,787,1718,0.458,564,1144,0.493,223,574,0.389,539,758,0.711,2336,2017,18
1373,Lehigh,2017-18,30,16,14,0.533,6151,835,1845,0.453,542,1124,0.482,293,721,0.406,373,480,0.777,2336,2017,18
1374,Hofstra,2010-11,33,21,12,0.636,6676,813,1835,0.443,605,1252,0.483,208,583,0.357,501,658,0.761,2335,2010,11
1375,UCSB,2015-16,33,19,14,0.576,6625,859,1944,0.442,608,1247,0.488,251,697,0.36,366,522,0.701,2335,2015,16
1376,Vermont,2013-14,33,22,11,0.667,6624,785,1673,0.469,590,1186,0.497,195,487,0.4,569,785,0.725,2334,2013,14
1377,Detroit,2014-15,33,15,18,0.455,6675,840,1889,0.445,609,1287,0.473,231,602,0.384,423,619,0.683,2334,2014,15
1378,Mercer,2014-15,35,19,16,0.543,7150,808,1840,0.439,596,1229,0.485,212,611,0.347,506,736,0.688,2334,2014,15
1379,Kansas State,2015-16,33,17,16,0.515,6721,805,1876,0.429,630,1293,0.487,175,583,0.3,549,798,0.688,2334,2015,16
1380,Ohio,2017-18,31,14,17,0.452,6400,839,1893,0.443,595,1232,0.483,244,661,0.369,412,579,0.712,2334,2017,18
1381,Cal St Northridge,2012-13,31,14,17,0.452,6200,818,1876,0.436,655,1391,0.471,163,485,0.336,534,729,0.733,2333,2012,13
1382,La Salle,2017-18,32,13,19,0.406,6575,817,1905,0.429,583,1195,0.488,234,710,0.33,465,591,0.787,2333,2017,18
1383,Wisconsin,2018-19,34,23,11,0.676,6921,874,1945,0.449,633,1273,0.497,241,672,0.359,344,531,0.648,2333,2018,19
1384,Miami (FL),2011-12,33,20,13,0.606,6750,814,1890,0.431,564,1176,0.48,250,714,0.35,454,630,0.721,2332,2011,12
1385,Miss Val St,2011-12,34,21,13,0.618,6875,812,2025,0.401,560,1248,0.449,252,777,0.324,456,708,0.644,2332,2011,12
1386,Western Mich.,2011-12,34,14,20,0.412,6875,801,1841,0.435,596,1235,0.483,205,606,0.338,525,741,0.709,2332,2011,12
1387,Akron,2013-14,34,21,13,0.618,6874,813,1855,0.438,574,1165,0.493,239,690,0.346,467,750,0.623,2332,2013,14
1388,Oral Roberts,2017-18,32,11,21,0.344,6550,879,2010,0.437,659,1369,0.481,220,641,0.343,354,517,0.685,2332,2017,18
1389,Loyola (MD),2018-19,32,11,21,0.344,6475,842,1836,0.459,632,1220,0.518,210,616,0.341,438,617,0.71,2332,2018,19
1390,Wofford,2014-15,35,28,7,0.8,7000,818,1802,0.454,596,1206,0.494,222,596,0.372,473,688,0.688,2331,2014,15
1391,Austin Peay,2016-17,30,11,19,0.367,6075,806,1718,0.469,579,1078,0.537,227,640,0.355,492,695,0.708,2331,2016,17
1392,Liberty,2016-17,35,21,14,0.6,7075,779,1787,0.436,460,899,0.512,319,888,0.359,454,612,0.742,2331,2016,17
1393,New Orleans,2016-17,32,20,12,0.625,6500,830,1755,0.473,691,1317,0.525,139,438,0.317,532,749,0.71,2331,2016,17
1394,Mt. St. Mary's,2017-18,32,18,14,0.563,6475,809,1778,0.455,486,925,0.525,323,853,0.379,390,532,0.733,2331,2017,18
1395,Clemson,2010-11,34,22,12,0.647,6850,810,1827,0.443,593,1197,0.495,217,630,0.344,493,703,0.701,2330,2010,11
1396,Alabama,2016-17,34,19,15,0.559,6900,809,1909,0.424,584,1199,0.487,225,710,0.317,487,746,0.653,2330,2016,17
1397,Idaho,2017-18,31,22,9,0.71,6225,819,1749,0.468,542,1070,0.507,277,679,0.408,415,565,0.735,2330,2017,18
1398,Elon,2014-15,33,15,18,0.455,6674,807,1906,0.423,567,1222,0.464,240,684,0.351,475,695,0.683,2329,2014,15
1399,San Francisco,2015-16,30,15,15,0.5,6098,808,1839,0.439,575,1180,0.487,233,659,0.354,480,708,0.678,2329,2015,16
1400,Ohio State,2016-17,32,17,15,0.531,6425,827,1786,0.463,616,1194,0.516,211,592,0.356,464,680,0.682,2329,2016,17
,,,,,,,,School,School,School,School,School,School,School,School,School,School,School,School,School,,
,Schl,Season,G,W,L,W-L%,MP,FG,FGA,FG%,2P,2PA,2P%,3P,3PA,3P%,FT,FTA,FT%,PTS,Season,
1401,Bradley,2018-19,35,20,15,0.571,7026,812,1874,0.433,572,1221,0.468,240,653,0.368,465,672,0.692,2329,2018,19
1402,Michigan,2010-11,35,21,14,0.6,7050,847,1889,0.448,564,1085,0.52,283,804,0.352,351,502,0.699,2328,2010,11
1403,St. Joseph's,2018-19,33,14,19,0.424,6625,793,1943,0.408,513,1074,0.478,280,869,0.322,462,615,0.751,2328,2018,19
1404,Portland,2013-14,31,15,16,0.484,6350,810,1778,0.456,619,1293,0.479,191,485,0.394,516,702,0.735,2327,2013,14
1405,Samford,2013-14,33,13,20,0.394,6626,849,1792,0.474,688,1304,0.528,161,488,0.33,468,692,0.676,2327,2013,14
1406,South Carolina,2018-19,32,16,16,0.5,6425,806,1907,0.423,564,1245,0.453,242,662,0.366,473,694,0.682,2327,2018,19
1407,Eastern Wash.,2011-12,32,15,17,0.469,6425,788,1914,0.412,505,1121,0.45,283,793,0.357,467,659,0.709,2326,2011,12
1408,Sacred Heart,2016-17,32,13,19,0.406,6525,832,1882,0.442,632,1285,0.492,200,597,0.335,462,659,0.701,2326,2016,17
1409,Hartford,2017-18,33,19,14,0.576,6625,835,1840,0.454,565,1057,0.535,270,783,0.345,386,569,0.678,2326,2017,18
1410,Cincinnati,2013-14,34,27,7,0.794,6801,805,1893,0.425,609,1308,0.466,196,585,0.335,519,733,0.708,2325,2013,14
1411,Chattanooga,2014-15,32,22,10,0.688,6525,793,1754,0.452,576,1133,0.508,217,621,0.349,522,762,0.685,2325,2014,15
1412,Seton Hall,2011-12,34,21,13,0.618,6875,833,1913,0.435,597,1245,0.48,236,668,0.353,422,626,0.674,2324,2011,12
1413,Loyola (IL),2014-15,37,24,13,0.649,7424,841,1776,0.474,617,1205,0.512,224,571,0.392,418,608,0.688,2324,2014,15
1414,Louisville,2015-16,31,23,8,0.742,6200,866,1847,0.469,680,1311,0.519,186,536,0.347,406,588,0.69,2324,2015,16
1415,Army,2016-17,32,13,19,0.406,6475,842,1906,0.442,551,1081,0.51,291,825,0.353,349,533,0.655,2324,2016,17
1416,Valparaiso,2011-12,34,22,12,0.647,6850,786,1682,0.467,557,1009,0.552,229,673,0.34,522,730,0.715,2323,2011,12
1417,George Mason,2011-12,33,24,9,0.727,6700,828,1788,0.463,672,1318,0.51,156,470,0.332,511,732,0.698,2323,2011,12
1418,Illinois State,2013-14,34,18,16,0.529,6875,767,1886,0.407,523,1105,0.473,244,781,0.312,545,774,0.704,2323,2013,14
1419,South Carolina,2013-14,34,14,20,0.412,6801,765,1853,0.413,570,1337,0.426,195,516,0.378,598,847,0.706,2323,2013,14
1420,Miss. St.,2015-16,31,14,17,0.452,6225,850,1862,0.456,625,1188,0.526,225,674,0.334,398,549,0.725,2323,2015,16
1421,Niagara,2011-12,33,14,19,0.424,6650,785,1940,0.405,536,1177,0.455,249,763,0.326,503,718,0.701,2322,2011,12
1422,Kent State,2011-12,33,21,12,0.636,6625,830,1836,0.452,630,1257,0.501,200,579,0.345,462,670,0.69,2322,2011,12
1423,James Madison,2018-19,33,14,19,0.424,6751,821,1859,0.442,578,1189,0.486,243,670,0.363,437,607,0.72,2322,2018,19
1424,Fla. Atlantic,2018-19,33,17,16,0.515,6675,809,1971,0.41,519,1076,0.482,290,895,0.324,414,551,0.751,2322,2018,19
1425,William & Mary,2018-19,31,14,17,0.452,6325,841,1773,0.474,587,1038,0.566,254,735,0.346,385,576,0.668,2321,2018,19
1426,Portland State,2013-14,32,17,15,0.531,6551,802,1729,0.464,606,1186,0.511,196,543,0.361,520,711,0.731,2320,2013,14
1427,Boston College,2016-17,32,9,23,0.281,6400,843,1880,0.448,587,1195,0.491,256,685,0.374,378,556,0.68,2320,2016,17
1428,Miss. St.,2016-17,32,16,16,0.5,6425,821,1849,0.444,574,1138,0.504,247,711,0.347,431,627,0.687,2320,2016,17
1429,East Carolina,2010-11,34,18,16,0.529,6851,735,1728,0.425,477,1007,0.474,258,721,0.358,591,854,0.692,2319,2010,11
1430,North Dakota,2010-11,34,19,15,0.559,6975,779,1826,0.427,564,1197,0.471,215,629,0.342,546,804,0.679,2319,2010,11
1431,IUPUI,2011-12,32,14,18,0.438,6475,819,1850,0.443,633,1325,0.478,186,525,0.354,495,638,0.776,2319,2011,12
1432,SMU,2015-16,30,25,5,0.833,5999,858,1727,0.497,664,1265,0.525,194,462,0.42,409,584,0.7,2319,2015,16
1433,LSU,2016-17,31,10,21,0.323,6200,853,1893,0.451,657,1309,0.502,196,584,0.336,417,599,0.696,2319,2016,17
1434,Providence,2016-17,33,20,13,0.606,6625,804,1795,0.448,565,1150,0.491,239,645,0.371,472,683,0.691,2319,2016,17
1435,Northern Ill.,2017-18,32,13,19,0.406,6425,849,1860,0.456,680,1348,0.504,169,512,0.33,452,623,0.726,2319,2017,18
1436,Oklahoma State,2010-11,34,20,14,0.588,6900,791,1814,0.436,648,1329,0.488,143,485,0.295,593,818,0.725,2318,2010,11
1437,North Florida,2013-14,32,16,16,0.5,6425,789,1784,0.442,562,1151,0.488,227,633,0.359,513,728,0.705,2318,2013,14
1438,Cal St Fullerton,2017-18,32,20,12,0.625,6450,804,1721,0.467,637,1221,0.522,167,500,0.334,543,745,0.729,2318,2017,18
1439,Niagara,2018-19,32,13,19,0.406,6425,795,1887,0.421,530,1149,0.461,265,738,0.359,463,629,0.736,2318,2018,19
1440,UTSA,2015-16,32,5,27,0.156,6450,796,1915,0.416,576,1224,0.471,220,691,0.318,505,719,0.702,2317,2015,16
1441,Tennessee Tech,2016-17,32,12,20,0.375,6500,785,1860,0.422,544,1118,0.487,241,742,0.325,506,715,0.708,2317,2016,17
1442,Duquesne,2017-18,32,16,16,0.5,6550,801,1874,0.427,540,1129,0.478,261,745,0.35,454,663,0.685,2317,2017,18
1443,Rhode Island,2010-11,34,20,14,0.588,6824,828,1960,0.422,585,1238,0.473,243,722,0.337,417,595,0.701,2316,2010,11
1444,Nevada,2013-14,32,15,17,0.469,6599,796,1835,0.434,582,1201,0.485,214,634,0.338,510,699,0.73,2316,2013,14
1445,New Mexico St.,2014-15,34,23,11,0.676,6850,808,1748,0.462,643,1298,0.495,165,450,0.367,535,771,0.694,2316,2014,15
1446,Nicholls State,2016-17,31,14,17,0.452,6275,771,1804,0.427,493,999,0.493,278,805,0.345,496,671,0.739,2316,2016,17
1447,California,2016-17,34,21,13,0.618,6899,807,1911,0.422,581,1247,0.466,226,664,0.34,476,720,0.661,2316,2016,17
1448,Vanderbilt,2017-18,32,12,20,0.375,6450,775,1775,0.437,486,956,0.508,289,819,0.353,477,642,0.743,2316,2017,18
1449,USC Upstate,2012-13,33,16,17,0.485,6624,843,1896,0.445,630,1282,0.491,213,614,0.347,416,640,0.65,2315,2012,13
1450,S Dakota St.,2013-14,32,19,13,0.594,6400,769,1719,0.447,560,1114,0.503,209,605,0.345,568,751,0.756,2315,2013,14
1451,Portland,2014-15,33,17,16,0.515,6700,810,1825,0.444,594,1251,0.475,216,574,0.376,479,668,0.717,2315,2014,15
1452,USC Upstate,2015-16,32,10,22,0.313,6450,860,1914,0.449,642,1274,0.504,218,640,0.341,377,590,0.639,2315,2015,16
1453,Chattanooga,2016-17,31,19,12,0.613,6225,801,1718,0.466,570,1051,0.542,231,667,0.346,481,677,0.71,2314,2016,17
1454,Colorado State,2017-18,32,11,21,0.344,6475,811,1941,0.418,586,1257,0.466,225,684,0.329,467,651,0.717,2314,2017,18
1455,George Mason,2018-19,33,18,15,0.545,6650,825,1855,0.445,615,1218,0.505,210,637,0.33,454,634,0.716,2314,2018,19
1456,Oral Roberts,2018-19,32,11,21,0.344,6425,854,1874,0.456,588,1140,0.516,266,734,0.362,340,492,0.691,2314,2018,19
1457,Richmond,2018-19,33,13,20,0.394,6599,849,1800,0.472,598,1077,0.555,251,723,0.347,365,552,0.661,2314,2018,19
1458,St. John's (NY),2010-11,33,21,12,0.636,6625,807,1773,0.455,664,1346,0.493,143,427,0.335,556,783,0.71,2313,2010,11
1459,Columbia,2013-14,34,21,13,0.618,6920,742,1662,0.446,464,945,0.491,278,717,0.388,551,711,0.775,2313,2013,14
1460,Richmond,2014-15,35,21,14,0.6,7150,834,1821,0.458,603,1141,0.528,231,680,0.34,414,600,0.69,2313,2014,15
1461,Kent State,2014-15,35,23,12,0.657,7100,797,1868,0.427,547,1175,0.466,250,693,0.361,469,713,0.658,2313,2014,15
1462,Fairl. Dickinson,2017-18,31,13,18,0.419,6200,842,1868,0.451,629,1245,0.505,213,623,0.342,416,573,0.726,2313,2017,18
1463,South Carolina,2017-18,33,17,16,0.515,6650,756,1899,0.398,516,1191,0.433,240,708,0.339,561,800,0.701,2313,2017,18
1464,Missouri State,2017-18,33,18,15,0.545,6624,851,1953,0.436,617,1246,0.495,234,707,0.331,377,527,0.715,2313,2017,18
1465,Indiana,2013-14,32,17,15,0.531,6425,780,1741,0.448,604,1229,0.491,176,512,0.344,576,789,0.73,2312,2013,14
1466,Purdue,2013-14,32,15,17,0.469,6549,822,1926,0.427,646,1388,0.465,176,538,0.327,492,733,0.671,2312,2013,14
1467,Yale,2017-18,31,16,15,0.516,6250,831,1797,0.462,579,1038,0.558,252,759,0.332,398,551,0.722,2312,2017,18
1468,Old Dominion,2013-14,36,18,18,0.5,7250,825,1927,0.428,635,1344,0.472,190,583,0.326,471,758,0.621,2311,2013,14
1469,Syracuse,2013-14,34,28,6,0.824,6850,819,1873,0.437,652,1368,0.477,167,505,0.331,506,715,0.708,2311,2013,14
1470,Longwood,2014-15,34,11,23,0.324,6900,809,1899,0.426,534,1153,0.463,275,746,0.369,418,580,0.721,2311,2014,15
1471,Howard,2015-16,32,12,20,0.375,6500,750,1846,0.406,606,1360,0.446,144,486,0.296,667,914,0.73,2311,2015,16
1472,Morgan State,2017-18,32,13,19,0.406,6300,787,1883,0.418,626,1405,0.446,161,478,0.337,538,742,0.725,2311,2017,18
1473,Wisconsin,2010-11,34,25,9,0.735,6849,798,1808,0.441,520,1064,0.489,278,744,0.374,436,533,0.818,2310,2010,11
1474,Marquette,2013-14,32,17,15,0.531,6600,800,1800,0.444,646,1320,0.489,154,480,0.321,556,806,0.69,2310,2013,14
1475,Northern Ill.,2016-17,32,15,17,0.469,6550,828,1891,0.438,667,1375,0.485,161,516,0.312,493,728,0.677,2310,2016,17
1476,Washington,2012-13,34,18,16,0.529,6850,841,1931,0.436,660,1403,0.47,181,528,0.343,446,653,0.683,2309,2012,13
1477,South Dakota,2014-15,33,17,16,0.515,6750,811,1924,0.422,599,1335,0.449,212,589,0.36,475,650,0.731,2309,2014,15
1478,Southern Ill.,2017-18,33,20,13,0.606,6700,839,1817,0.462,624,1213,0.514,215,604,0.356,415,596,0.696,2308,2017,18
1479,Temple,2017-18,33,17,16,0.515,6651,845,1990,0.425,574,1216,0.472,271,774,0.35,347,509,0.682,2308,2017,18
1480,Villanova,2012-13,34,20,14,0.588,6925,732,1760,0.416,528,1143,0.462,204,617,0.331,639,889,0.719,2307,2012,13
1481,UMBC,2015-16,32,7,25,0.219,6450,788,1788,0.441,572,1136,0.504,216,652,0.331,515,754,0.683,2307,2015,16
1482,Colorado,2017-18,32,17,15,0.531,6475,810,1839,0.44,569,1167,0.488,241,672,0.359,446,612,0.729,2307,2017,18
1483,Ark-Pine Bluff,2017-18,35,14,21,0.4,7050,815,1863,0.437,598,1203,0.497,217,660,0.329,460,681,0.675,2307,2017,18
1484,Xavier,2010-11,32,24,8,0.75,6500,784,1700,0.461,611,1174,0.52,173,526,0.329,565,756,0.747,2306,2010,11
1485,Fla. Gulf Coast,2011-12,32,15,17,0.469,6450,823,1806,0.456,572,1134,0.504,251,672,0.374,409,608,0.673,2306,2011,12
1486,Pitt,2018-19,33,14,19,0.424,6650,769,1841,0.418,544,1161,0.469,225,680,0.331,543,779,0.697,2306,2018,19
1487,Utah Valley,2011-12,33,20,13,0.606,6675,819,1931,0.424,630,1332,0.473,189,599,0.316,478,685,0.698,2305,2011,12
1488,Texas Tech,2015-16,32,19,13,0.594,6475,785,1754,0.448,600,1220,0.492,185,534,0.346,550,741,0.742,2305,2015,16
1489,Wisconsin,2011-12,36,26,10,0.722,7250,797,1875,0.425,512,1100,0.465,285,775,0.368,425,575,0.739,2304,2011,12
1490,Oregon State,2012-13,32,14,18,0.438,6425,829,1855,0.447,643,1344,0.478,186,511,0.364,460,687,0.67,2304,2012,13
1491,UT-Martin,2013-14,31,8,23,0.258,6199,792,1870,0.424,574,1234,0.465,218,636,0.343,502,692,0.725,2304,2013,14
1492,Green Bay,2013-14,31,24,7,0.774,6250,813,1715,0.474,663,1291,0.514,150,424,0.354,528,751,0.703,2304,2013,14
1493,Northwestern,2015-16,32,20,12,0.625,6526,837,1859,0.45,559,1083,0.516,278,776,0.358,352,528,0.667,2304,2015,16
1494,Charleston So.,2016-17,31,12,19,0.387,6276,824,1868,0.441,596,1199,0.497,228,669,0.341,428,643,0.666,2304,2016,17
1495,Western Caro.,2018-19,32,7,25,0.219,6475,792,1744,0.454,496,944,0.525,296,800,0.37,424,628,0.675,2304,2018,19
1496,Western Caro.,2010-11,33,18,15,0.545,6625,857,1991,0.43,667,1420,0.47,190,571,0.333,399,613,0.651,2303,2010,11
1497,West Virginia,2010-11,33,21,12,0.636,6600,783,1826,0.429,577,1215,0.475,206,611,0.337,531,747,0.711,2303,2010,11
1498,Notre Dame,2013-14,32,15,17,0.469,6524,839,1842,0.455,611,1205,0.507,228,637,0.358,397,553,0.718,2303,2013,14
1499,SMU,2018-19,32,15,17,0.469,6400,833,1884,0.442,570,1112,0.513,263,772,0.341,374,523,0.715,2303,2018,19
1500,Belmont,2016-17,30,23,7,0.767,6024,798,1703,0.469,492,808,0.609,306,895,0.342,400,521,0.768,2302,2016,17
,,,,,,,,School,School,School,School,School,School,School,School,School,School,School,School,School,,
,Schl,Season,G,W,L,W-L%,MP,FG,FGA,FG%,2P,2PA,2P%,3P,3PA,3P%,FT,FTA,FT%,PTS,Season,
1501,North Texas,2018-19,33,21,12,0.636,6619,831,1910,0.435,547,1072,0.51,284,838,0.339,356,532,0.669,2302,2018,19
1502,Elon,2010-11,31,14,17,0.452,6200,765,1785,0.429,480,1002,0.479,285,783,0.364,486,681,0.714,2301,2010,11
1503,Idaho,2014-15,30,13,17,0.433,6100,805,1726,0.466,569,1154,0.493,236,572,0.413,455,642,0.709,2301,2014,15
1504,Oregon State,2015-16,32,19,13,0.594,6399,811,1843,0.44,593,1256,0.472,218,587,0.371,461,687,0.671,2301,2015,16
1505,Little Rock,2018-19,31,10,21,0.323,6250,817,1687,0.484,611,1105,0.553,206,582,0.354,461,703,0.656,2301,2018,19
1506,Wake Forest,2013-14,33,17,16,0.515,6618,784,1740,0.451,618,1235,0.5,166,505,0.329,566,871,0.65,2300,2013,14
1507,Manhattan,2014-15,33,19,14,0.576,6700,756,1748,0.432,541,1108,0.488,215,640,0.336,573,829,0.691,2300,2014,15
1508,Cleveland State,2018-19,31,10,21,0.323,6250,799,1834,0.436,496,1014,0.489,303,820,0.37,399,585,0.682,2300,2018,19
1509,Old Dominion,2018-19,35,26,9,0.743,7000,823,2026,0.406,559,1270,0.44,264,756,0.349,388,585,0.663,2300,2018,19
1510,Northern Ariz.,2010-11,32,19,13,0.594,6450,850,1747,0.487,645,1262,0.511,205,485,0.423,394,593,0.664,2299,2010,11
1511,Arkansas,2011-12,32,18,14,0.563,6400,808,1860,0.434,603,1280,0.471,205,580,0.353,478,692,0.691,2299,2011,12
1512,N.C. A&T,2012-13,37,20,17,0.541,7425,776,1927,0.403,561,1220,0.46,215,707,0.304,532,809,0.658,2299,2012,13
1513,Providence,2012-13,34,19,15,0.559,6875,801,1947,0.411,615,1347,0.457,186,600,0.31,511,728,0.702,2299,2012,13
1514,UC-Riverside,2015-16,33,14,19,0.424,6601,788,1839,0.428,536,1123,0.477,252,716,0.352,471,670,0.703,2299,2015,16
1515,Eastern Ill.,2018-19,32,14,18,0.438,6550,826,1912,0.432,554,1177,0.471,272,735,0.37,375,545,0.688,2299,2018,19
1516,DePaul,2011-12,31,12,19,0.387,6225,857,1956,0.438,633,1287,0.492,224,669,0.335,360,517,0.696,2298,2011,12
1517,Idaho,2011-12,33,19,14,0.576,6650,807,1692,0.477,592,1143,0.518,215,549,0.392,469,697,0.673,2298,2011,12
1518,Georgia State,2011-12,34,22,12,0.647,6900,842,1936,0.435,664,1374,0.483,178,562,0.317,436,665,0.656,2298,2011,12
1519,Incarnate Word,2014-15,29,18,11,0.621,5950,773,1647,0.469,569,1097,0.519,204,550,0.371,548,747,0.734,2298,2014,15
1520,Nicholls State,2015-16,34,11,23,0.324,6875,787,1875,0.42,575,1181,0.487,212,694,0.305,512,782,0.655,2298,2015,16
1521,Coastal Caro.,2017-18,32,14,18,0.438,6450,787,1813,0.434,569,1153,0.493,218,660,0.33,506,702,0.721,2298,2017,18
1522,Charleston,2012-13,35,24,11,0.686,6999,803,1819,0.441,594,1217,0.488,209,602,0.347,482,703,0.686,2297,2012,13
1523,Idaho State,2015-16,31,16,15,0.516,6200,769,1767,0.435,519,1080,0.481,250,687,0.364,509,700,0.727,2297,2015,16
1524,Richmond,2017-18,32,12,20,0.375,6474,843,1830,0.461,621,1166,0.533,222,664,0.334,389,544,0.715,2297,2017,18
1525,New Orleans,2017-18,33,16,17,0.485,6625,815,1798,0.453,656,1354,0.484,159,444,0.358,508,755,0.673,2297,2017,18
1526,Miami (FL),2018-19,32,14,18,0.438,6425,805,1851,0.435,537,1046,0.513,268,805,0.333,419,570,0.735,2297,2018,19
1527,UNC Asheville,2012-13,32,16,16,0.5,6425,824,1831,0.45,669,1363,0.491,155,468,0.331,493,690,0.714,2296,2012,13
1528,Drake,2012-13,32,15,17,0.469,6475,775,1732,0.447,496,1012,0.49,279,720,0.388,467,651,0.717,2296,2012,13
1529,Wofford,2015-16,32,15,17,0.469,6475,771,1725,0.447,501,1063,0.471,270,662,0.408,484,645,0.75,2296,2015,16
1530,Akron,2017-18,32,14,18,0.438,6475,793,1824,0.435,488,973,0.502,305,851,0.358,405,582,0.696,2296,2017,18
1531,Tulsa,2018-19,32,18,14,0.563,6450,776,1732,0.448,554,1080,0.513,222,652,0.34,522,751,0.695,2296,2018,19
1532,UMBC,2018-19,34,21,13,0.618,6994,820,1893,0.433,559,1086,0.515,261,807,0.323,395,573,0.689,2296,2018,19
1533,Quinnipiac,2010-11,32,22,10,0.688,6400,847,1979,0.428,672,1471,0.457,175,508,0.344,426,697,0.611,2295,2010,11
1534,UC-Irvine,2014-15,34,21,13,0.618,6850,854,1851,0.461,637,1293,0.493,217,558,0.389,370,541,0.684,2295,2014,15
1535,Wake Forest,2015-16,31,11,20,0.355,6250,793,1804,0.44,598,1186,0.504,195,618,0.316,514,779,0.66,2295,2015,16
1536,Charlotte,2016-17,30,13,17,0.433,6025,800,1803,0.444,563,1173,0.48,237,630,0.376,458,614,0.746,2295,2016,17
1537,Bryant,2012-13,31,19,12,0.613,6225,812,1693,0.48,595,1083,0.549,217,610,0.356,453,627,0.722,2294,2012,13
1538,Central Ark.,2012-13,30,13,17,0.433,6150,856,1967,0.435,642,1359,0.472,214,608,0.352,368,582,0.632,2294,2012,13
1539,Cleveland State,2014-15,34,19,15,0.559,6876,826,1820,0.454,579,1174,0.493,247,646,0.382,395,576,0.686,2294,2014,15
1540,Princeton,2015-16,29,22,7,0.759,5875,800,1725,0.464,518,989,0.524,282,736,0.383,412,579,0.712,2294,2015,16
1541,Wyoming,2015-16,32,14,18,0.438,6475,720,1626,0.443,401,769,0.521,319,857,0.372,535,747,0.716,2294,2015,16
1542,Quinnipiac,2018-19,31,16,15,0.516,6350,739,1730,0.427,391,807,0.485,348,923,0.377,468,646,0.724,2294,2018,19
1543,Miss Val St,2013-14,32,9,23,0.281,6403,808,1934,0.418,605,1288,0.47,203,646,0.314,474,707,0.67,2293,2013,14
1544,Miss Val St,2015-16,35,8,27,0.229,7154,826,2129,0.388,647,1539,0.42,179,590,0.303,462,667,0.693,2293,2015,16
1545,SMU,2017-18,33,17,16,0.515,6600,814,1835,0.444,533,1094,0.487,281,741,0.379,384,560,0.686,2293,2017,18
1546,Rhode Island,2018-19,33,18,15,0.545,6674,821,1914,0.429,649,1299,0.5,172,615,0.28,479,704,0.68,2293,2018,19
1547,Texas State,2011-12,30,13,17,0.433,6000,796,1842,0.432,551,1163,0.474,245,679,0.361,455,639,0.712,2292,2011,12
1548,Rider,2013-14,31,14,17,0.452,6300,743,1704,0.436,506,1107,0.457,237,597,0.397,569,778,0.731,2292,2013,14
1549,Northern Colo.,2015-16,31,10,21,0.323,6200,780,1726,0.452,577,1181,0.489,203,545,0.372,529,727,0.728,2292,2015,16
1550,Rider,2011-12,32,13,19,0.406,6475,771,1712,0.45,525,1059,0.496,246,653,0.377,503,699,0.72,2291,2011,12
1551,CS Long Beach,2012-13,33,19,14,0.576,6624,811,1836,0.442,588,1180,0.498,223,656,0.34,446,675,0.661,2291,2012,13
1552,Temple,2013-14,31,9,22,0.29,6325,828,1934,0.428,627,1340,0.468,201,594,0.338,434,614,0.707,2291,2013,14
1553,DePaul,2013-14,33,12,21,0.364,6700,782,1848,0.423,587,1268,0.463,195,580,0.336,531,776,0.684,2290,2013,14
1554,Evansville,2013-14,33,14,19,0.424,6650,775,1672,0.464,631,1274,0.495,144,398,0.362,596,830,0.718,2290,2013,14
1555,UNC Greensboro,2014-15,33,11,22,0.333,6650,838,1895,0.442,622,1297,0.48,216,598,0.361,398,613,0.649,2290,2014,15
1556,Stony Brook,2014-15,35,23,12,0.657,7025,835,1999,0.418,644,1423,0.453,191,576,0.332,429,647,0.663,2290,2014,15
1557,Texas,2014-15,34,20,14,0.588,6875,796,1837,0.433,584,1211,0.482,212,626,0.339,486,671,0.724,2290,2014,15
1558,Bethune-Cookman,2018-19,31,14,17,0.452,6250,833,1899,0.439,629,1264,0.498,204,635,0.321,420,689,0.61,2290,2018,19
1559,Pepperdine,2010-11,33,12,21,0.364,6650,787,1855,0.424,610,1314,0.464,177,541,0.327,538,749,0.718,2289,2010,11
1560,Stephen F. Austin,2016-17,33,18,15,0.545,6651,783,1754,0.446,590,1149,0.513,193,605,0.319,530,735,0.721,2289,2016,17
1561,Chattanooga,2017-18,33,10,23,0.303,6725,784,1804,0.435,508,1028,0.494,276,776,0.356,445,626,0.711,2289,2017,18
1562,Western Caro.,2012-13,33,14,19,0.424,6650,828,1925,0.43,621,1314,0.473,207,611,0.339,425,604,0.704,2288,2012,13
1563,Little Rock,2013-14,32,15,17,0.469,6600,784,1844,0.425,620,1339,0.463,164,505,0.325,556,754,0.737,2288,2013,14
1564,Evansville,2016-17,33,16,17,0.485,6675,800,1762,0.454,673,1415,0.476,127,347,0.366,561,787,0.713,2288,2016,17
1565,Lipscomb,2010-11,30,17,13,0.567,6075,793,1750,0.453,594,1154,0.515,199,596,0.334,502,711,0.706,2287,2010,11
1566,Northern Colo.,2010-11,32,21,11,0.656,6400,731,1708,0.428,477,1051,0.454,254,657,0.387,571,742,0.77,2287,2010,11
1567,Austin Peay,2013-14,30,12,18,0.4,6074,797,1632,0.488,639,1173,0.545,158,459,0.344,535,804,0.665,2287,2013,14
1568,Clemson,2013-14,36,23,13,0.639,7356,796,1879,0.424,606,1266,0.479,190,613,0.31,505,679,0.744,2287,2013,14
1569,Youngstown St.,2014-15,32,11,21,0.344,6450,807,1826,0.442,599,1238,0.484,208,588,0.354,465,670,0.694,2287,2014,15
1570,Northwestern,2011-12,33,19,14,0.576,6675,790,1754,0.45,493,983,0.502,297,771,0.385,409,592,0.691,2286,2011,12
1571,UMass-Lowell,2017-18,30,12,18,0.4,6025,791,1719,0.46,576,1098,0.525,215,621,0.346,489,690,0.709,2286,2017,18
1572,Monmouth,2018-19,35,14,21,0.4,7095,794,1915,0.415,626,1350,0.464,168,565,0.297,530,773,0.686,2286,2018,19
1573,Middle Tenn.,2014-15,36,19,17,0.528,7376,773,1867,0.414,531,1192,0.445,242,675,0.359,497,710,0.7,2285,2014,15
1574,Western Ky.,2014-15,32,20,12,0.625,6474,793,1824,0.435,545,1139,0.478,248,685,0.362,451,690,0.654,2285,2014,15
1575,Campbell,2012-13,33,13,20,0.394,6750,855,1921,0.445,720,1481,0.486,135,440,0.307,439,619,0.709,2284,2012,13
1576,DePaul,2012-13,32,11,21,0.344,6475,847,1951,0.434,692,1433,0.483,155,518,0.299,435,618,0.704,2284,2012,13
1577,South Alabama,2015-16,33,14,19,0.424,6725,784,1917,0.409,571,1257,0.454,213,660,0.323,503,747,0.673,2284,2015,16
1578,South Alabama,2016-17,32,14,18,0.438,6500,793,1859,0.427,570,1157,0.493,223,702,0.318,475,725,0.655,2284,2016,17
1579,Texas-Arlington,2018-19,33,17,16,0.515,6725,781,1908,0.409,547,1135,0.482,234,773,0.303,488,659,0.741,2284,2018,19
1580,Bethune-Cookman,2012-13,34,14,20,0.412,6850,815,1957,0.416,625,1337,0.467,190,620,0.306,463,742,0.624,2283,2012,13
1581,New Mexico,2016-17,31,17,14,0.548,6225,778,1693,0.46,633,1249,0.507,145,444,0.327,582,780,0.746,2283,2016,17
1582,Virginia,2017-18,34,31,3,0.912,6825,848,1844,0.46,601,1199,0.501,247,645,0.383,340,451,0.754,2283,2017,18
1583,Pepperdine,2017-18,32,6,26,0.188,6450,822,1829,0.449,636,1287,0.494,186,542,0.343,453,646,0.701,2283,2017,18
1584,N.C. A&T,2010-11,32,15,17,0.469,6525,779,1806,0.431,574,1175,0.489,205,631,0.325,519,780,0.665,2282,2010,11
1585,Lehigh,2010-11,31,16,15,0.516,6276,743,1781,0.417,571,1256,0.455,172,525,0.328,624,826,0.755,2282,2010,11
1586,North Dakota St.,2012-13,34,24,10,0.706,6850,838,1789,0.468,604,1135,0.532,234,654,0.358,372,515,0.722,2282,2012,13
1587,Pitt,2012-13,33,24,9,0.727,6675,837,1775,0.472,674,1308,0.515,163,467,0.349,445,666,0.668,2282,2012,13
1588,UTEP,2014-15,33,22,11,0.667,6625,800,1717,0.466,615,1211,0.508,185,506,0.366,497,752,0.661,2282,2014,15
1589,Arkansas State,2015-16,31,11,20,0.355,6302,770,1855,0.415,590,1285,0.459,180,570,0.316,562,766,0.734,2282,2015,16
1590,Grand Canyon,2016-17,31,22,9,0.71,6250,790,1812,0.436,585,1193,0.49,205,619,0.331,497,747,0.665,2282,2016,17
1591,Florida A&M,2013-14,32,14,18,0.438,6450,809,2010,0.402,596,1373,0.434,213,637,0.334,450,688,0.654,2281,2013,14
1592,Illinois,2014-15,33,19,14,0.576,6650,786,1903,0.413,548,1233,0.444,238,670,0.355,471,593,0.794,2281,2014,15
1593,Northern Iowa,2014-15,35,31,4,0.886,7101,776,1618,0.48,519,973,0.533,257,645,0.398,472,644,0.733,2281,2014,15
1594,Kansas State,2013-14,33,20,13,0.606,6674,798,1840,0.434,600,1242,0.483,198,598,0.331,486,741,0.656,2280,2013,14
1595,Alabama,2014-15,34,19,15,0.559,6855,760,1724,0.441,539,1027,0.525,221,697,0.317,539,752,0.717,2280,2014,15
1596,Utah Valley,2015-16,30,12,18,0.4,6055,785,1835,0.428,529,1105,0.479,256,730,0.351,454,628,0.723,2280,2015,16
1597,Pacific,2017-18,32,14,18,0.438,6450,804,1782,0.451,653,1323,0.494,151,459,0.329,521,715,0.729,2280,2017,18
1598,Fla. Gulf Coast,2018-19,32,14,18,0.438,6400,809,1787,0.453,540,1063,0.508,269,724,0.372,393,588,0.668,2280,2018,19
1599,Colorado State,2010-11,32,19,13,0.594,6425,798,1707,0.467,611,1146,0.533,187,561,0.333,496,717,0.692,2279,2010,11
1600,Drake,2011-12,34,18,16,0.529,6900,788,1794,0.439,576,1209,0.476,212,585,0.362,491,749,0.656,2279,2011,12
,,,,,,,,School,School,School,School,School,School,School,School,School,School,School,School,School,,
,Schl,Season,G,W,L,W-L%,MP,FG,FGA,FG%,2P,2PA,2P%,3P,3PA,3P%,FT,FTA,FT%,PTS,Season,
1601,Pitt,2014-15,34,19,15,0.559,6875,835,1866,0.447,671,1382,0.486,164,484,0.339,445,650,0.685,2279,2014,15
1602,Vermont,2014-15,34,20,14,0.588,6850,801,1701,0.471,619,1188,0.521,182,513,0.355,495,715,0.692,2279,2014,15
1603,Maine,2015-16,30,8,22,0.267,6073,825,1909,0.432,597,1236,0.483,228,673,0.339,401,611,0.656,2279,2015,16
1604,Southern,2017-18,33,15,18,0.455,6650,781,1937,0.403,604,1413,0.427,177,524,0.338,540,793,0.681,2279,2017,18
1605,Detroit,2018-19,31,11,20,0.355,6200,784,1874,0.418,490,1049,0.467,294,825,0.356,417,581,0.718,2279,2018,19
1606,Georgetown,2011-12,33,24,9,0.727,6700,811,1743,0.465,625,1207,0.518,186,536,0.347,470,673,0.698,2278,2011,12
1607,Florida State,2012-13,34,18,16,0.529,6800,780,1758,0.444,584,1195,0.489,196,563,0.348,522,710,0.735,2278,2012,13
1608,Southern,2013-14,32,19,13,0.594,6450,823,1822,0.452,635,1268,0.501,188,554,0.339,444,718,0.618,2278,2013,14
1609,N.C. Central,2014-15,33,25,8,0.758,6625,813,1668,0.487,594,1075,0.553,219,593,0.369,433,632,0.685,2278,2014,15
1610,LIU,2016-17,32,20,12,0.625,6475,803,1846,0.435,619,1312,0.472,184,534,0.345,488,710,0.687,2278,2016,17
1611,Miami (FL),2016-17,33,21,12,0.636,6625,813,1800,0.452,604,1213,0.498,209,587,0.356,443,617,0.718,2278,2016,17
1612,Loyola Marymount,2018-19,34,22,12,0.647,6800,817,1800,0.454,654,1290,0.507,163,510,0.32,481,645,0.746,2278,2018,19
1613,Sacred Heart,2011-12,32,14,18,0.438,6500,807,1756,0.46,600,1195,0.502,207,561,0.369,456,612,0.745,2277,2011,12
1614,Bucknell,2012-13,34,28,6,0.824,6800,818,1807,0.453,661,1369,0.483,157,438,0.358,484,652,0.742,2277,2012,13
1615,Holy Cross,2013-14,34,20,14,0.588,6853,771,1795,0.43,554,1180,0.469,217,615,0.353,518,708,0.732,2277,2013,14
1616,Charleston So.,2014-15,31,19,12,0.613,6296,777,1846,0.421,489,1001,0.489,288,845,0.341,435,633,0.687,2277,2014,15
1617,FIU,2015-16,32,13,19,0.406,6500,834,1779,0.469,653,1280,0.51,181,499,0.363,428,645,0.664,2277,2015,16
1618,New Hampshire,2016-17,32,20,12,0.625,6500,783,1787,0.438,527,1060,0.497,256,727,0.352,455,628,0.725,2277,2016,17
1619,Tulsa,2017-18,31,19,12,0.613,6275,754,1730,0.436,507,1020,0.497,247,710,0.348,522,720,0.725,2277,2017,18
1620,Utah Valley,2010-11,30,19,11,0.633,6125,744,1682,0.442,547,1136,0.482,197,546,0.361,591,780,0.758,2276,2010,11
1621,Longwood,2011-12,31,10,21,0.323,6225,826,1905,0.434,561,1146,0.49,265,759,0.349,359,531,0.676,2276,2011,12
1622,Bethune-Cookman,2011-12,35,18,17,0.514,7025,818,1890,0.433,640,1368,0.468,178,522,0.341,462,702,0.658,2276,2011,12
1623,Delaware,2012-13,33,19,14,0.576,6700,776,1833,0.423,632,1367,0.462,144,466,0.309,580,769,0.754,2276,2012,13
1624,Lipscomb,2013-14,30,15,15,0.5,6050,727,1683,0.432,452,905,0.499,275,778,0.353,547,800,0.684,2276,2013,14
1625,Prairie View,2016-17,33,13,20,0.394,6651,788,1839,0.428,551,1161,0.475,237,678,0.35,463,659,0.703,2276,2016,17
1626,UNLV,2018-19,31,17,14,0.548,6250,791,1852,0.427,540,1107,0.488,251,745,0.337,443,647,0.685,2276,2018,19
1627,Ole Miss,2011-12,34,20,14,0.588,6975,820,1896,0.432,671,1425,0.471,149,471,0.316,486,806,0.603,2275,2011,12
1628,Wagner,2011-12,31,25,6,0.806,6200,779,1767,0.441,575,1201,0.479,204,566,0.36,513,690,0.743,2275,2011,12
1629,Buffalo,2012-13,34,14,20,0.412,6851,794,1767,0.449,579,1147,0.505,215,620,0.347,472,671,0.703,2275,2012,13
1630,Detroit,2013-14,32,13,19,0.406,6525,778,1863,0.418,587,1268,0.463,191,595,0.321,528,724,0.729,2275,2013,14
1631,South Alabama,2014-15,33,12,21,0.364,6677,762,1813,0.42,548,1173,0.467,214,640,0.334,537,764,0.703,2275,2014,15
1632,Brown,2016-17,30,13,17,0.433,6000,735,1660,0.443,491,995,0.493,244,665,0.367,561,739,0.759,2275,2016,17
1633,Bethune-Cookman,2016-17,32,10,22,0.313,6575,840,2022,0.415,612,1310,0.467,228,712,0.32,367,554,0.662,2275,2016,17
1634,Oregon State,2018-19,31,18,13,0.581,6251,800,1728,0.463,597,1095,0.545,203,633,0.321,472,636,0.742,2275,2018,19
1635,Chattanooga,2010-11,32,16,16,0.5,6475,761,1827,0.417,489,981,0.498,272,846,0.322,480,740,0.649,2274,2010,11
1636,Wisconsin,2012-13,35,23,12,0.657,7100,823,1960,0.42,564,1175,0.48,259,785,0.33,369,582,0.634,2274,2012,13
1637,Utah State,2015-16,31,16,15,0.516,6200,802,1779,0.451,545,1084,0.503,257,695,0.37,413,597,0.692,2274,2015,16
1638,Georgia,2018-19,32,11,21,0.344,6400,776,1761,0.441,566,1108,0.511,210,653,0.322,512,726,0.705,2274,2018,19
1639,Northeastern,2012-13,33,20,13,0.606,6751,768,1733,0.443,537,1111,0.483,231,622,0.371,506,672,0.753,2273,2012,13
1640,Elon,2012-13,33,21,12,0.636,6677,814,1884,0.432,556,1135,0.49,258,749,0.344,387,543,0.713,2273,2012,13
1641,Penn State,2014-15,34,18,16,0.529,6900,795,1893,0.42,568,1214,0.468,227,679,0.334,456,656,0.695,2273,2014,15
1642,Old Dominion,2014-15,35,27,8,0.771,7050,836,1935,0.432,629,1299,0.484,207,636,0.325,394,592,0.666,2273,2014,15
1643,Tennessee State,2015-16,31,20,11,0.645,6300,795,1760,0.452,622,1243,0.5,173,517,0.335,510,734,0.695,2273,2015,16
1644,Denver,2016-17,30,16,14,0.533,6049,811,1684,0.482,588,1129,0.521,223,555,0.402,428,583,0.734,2273,2016,17
1645,Wake Forest,2017-18,31,11,20,0.355,6200,801,1826,0.439,560,1182,0.474,241,644,0.374,430,583,0.738,2273,2017,18
1646,Portland,2010-11,32,20,12,0.625,6450,800,1749,0.457,557,1159,0.481,243,590,0.412,429,577,0.744,2272,2010,11
1647,Western Ky.,2011-12,35,16,19,0.457,7050,769,1952,0.394,574,1314,0.437,195,638,0.306,539,785,0.687,2272,2011,12
1648,Robert Morris,2017-18,33,16,17,0.485,6625,794,1932,0.411,552,1203,0.459,242,729,0.332,442,663,0.667,2272,2017,18
1649,UCF,2010-11,33,21,12,0.636,6600,767,1690,0.454,572,1108,0.516,195,582,0.335,542,785,0.69,2271,2010,11
1650,Furman,2010-11,33,22,11,0.667,6650,765,1712,0.447,527,1076,0.49,238,636,0.374,503,694,0.725,2271,2010,11
1651,Quinnipiac,2011-12,32,18,14,0.563,6451,828,1943,0.426,687,1520,0.452,141,423,0.333,474,743,0.638,2271,2011,12
1652,North Dakota St.,2015-16,33,20,13,0.606,6626,817,1837,0.445,603,1207,0.5,214,630,0.34,423,619,0.683,2271,2015,16
1653,Akron,2018-19,33,17,16,0.515,6625,797,1948,0.409,500,1019,0.491,297,929,0.32,380,539,0.705,2271,2018,19
1654,Boston U.,2010-11,35,21,14,0.6,7025,749,1865,0.402,484,1118,0.433,265,747,0.355,507,695,0.729,2270,2010,11
1655,Longwood,2012-13,33,8,25,0.242,6625,841,1898,0.443,674,1374,0.491,167,524,0.319,421,593,0.71,2270,2012,13
1656,Maryland,2013-14,32,17,15,0.531,6473,792,1844,0.43,566,1184,0.478,226,660,0.342,460,677,0.679,2270,2013,14
1657,Washington St.,2017-18,31,12,19,0.387,6250,801,1795,0.446,460,890,0.517,341,905,0.377,327,444,0.736,2270,2017,18
1658,Temple,2016-17,32,16,16,0.5,6475,808,1916,0.422,521,1109,0.47,287,807,0.356,366,506,0.723,2269,2016,17
1659,Tulane,2017-18,31,14,17,0.452,6250,800,1779,0.45,568,1116,0.509,232,663,0.35,437,613,0.713,2269,2017,18
1660,Arizona,2018-19,32,17,15,0.531,6451,794,1861,0.427,559,1162,0.481,235,699,0.336,446,620,0.719,2269,2018,19
1661,Alabama,2012-13,36,23,13,0.639,7275,808,1887,0.428,611,1299,0.47,197,588,0.335,455,648,0.702,2268,2012,13
1662,Lehigh,2015-16,32,17,15,0.531,6400,810,1777,0.456,573,1173,0.488,237,604,0.392,411,565,0.727,2268,2015,16
1663,Southeastern LA,2016-17,32,16,16,0.5,6400,796,1770,0.45,581,1177,0.494,215,593,0.363,461,675,0.683,2268,2016,17
1664,Army,2018-19,32,13,19,0.406,6400,837,1956,0.428,565,1093,0.517,272,863,0.315,322,471,0.684,2268,2018,19
1665,Chattanooga,2018-19,32,12,20,0.375,6425,833,1881,0.443,543,1086,0.5,290,795,0.365,312,457,0.683,2268,2018,19
1666,Georgia,2010-11,33,21,12,0.636,6750,823,1822,0.452,667,1366,0.488,156,456,0.342,465,667,0.697,2267,2010,11
1667,North Dakota St.,2011-12,31,17,14,0.548,6250,805,1649,0.488,606,1118,0.542,199,531,0.375,458,635,0.721,2267,2011,12
1668,UNC Greensboro,2013-14,32,14,18,0.438,6448,808,1835,0.44,641,1347,0.476,167,488,0.342,484,704,0.688,2267,2013,14
1669,Holy Cross,2015-16,35,15,20,0.429,7125,775,1879,0.412,524,1110,0.472,251,769,0.326,466,678,0.687,2267,2015,16
1670,Temple,2015-16,33,21,12,0.636,6724,822,2021,0.407,567,1264,0.449,255,757,0.337,368,538,0.684,2267,2015,16
1671,Mercer,2016-17,32,15,17,0.469,6475,787,1774,0.444,543,1076,0.505,244,698,0.35,449,574,0.782,2267,2016,17
1672,Miami (OH),2018-19,32,15,17,0.469,6422,777,1847,0.421,508,1015,0.5,269,832,0.323,444,626,0.709,2267,2018,19
1673,Milwaukee,2010-11,33,19,14,0.576,6675,755,1753,0.431,505,1042,0.485,250,711,0.352,506,773,0.655,2266,2010,11
1674,Villanova,2011-12,32,13,19,0.406,6500,762,1848,0.412,566,1226,0.462,196,622,0.315,546,724,0.754,2266,2011,12
1675,Lehigh,2012-13,31,21,10,0.677,6200,788,1705,0.462,553,1105,0.5,235,600,0.392,455,617,0.737,2266,2012,13
1676,UAB,2013-14,31,18,13,0.581,6276,800,1919,0.417,642,1394,0.461,158,525,0.301,508,772,0.658,2266,2013,14
1677,Tx AM-CC,2014-15,34,20,14,0.588,6826,748,1678,0.446,583,1179,0.494,165,499,0.331,605,881,0.687,2266,2014,15
1678,Radford,2015-16,31,16,15,0.516,6349,844,1885,0.448,618,1227,0.504,226,658,0.343,352,541,0.651,2266,2015,16
1679,La Salle,2016-17,30,15,15,0.5,6100,761,1666,0.457,506,966,0.524,255,700,0.364,489,638,0.766,2266,2016,17
1680,Notre Dame,2018-19,33,14,19,0.424,6599,776,1973,0.393,504,1110,0.454,272,863,0.315,442,594,0.744,2266,2018,19
1681,Elon,2018-19,32,11,21,0.344,6450,812,1862,0.436,477,919,0.519,335,943,0.355,307,443,0.693,2266,2018,19
1682,Loyola Marymount,2010-11,32,11,21,0.344,6525,807,1869,0.432,658,1406,0.468,149,463,0.322,502,723,0.694,2265,2010,11
1683,App. St.,2010-11,31,16,15,0.516,6225,790,1738,0.455,594,1156,0.514,196,582,0.337,489,694,0.705,2265,2010,11
1684,Alabama State,2013-14,32,19,13,0.594,6495,792,1891,0.419,617,1279,0.482,175,612,0.286,506,748,0.676,2265,2013,14
1685,SIU Edwardsville,2018-19,31,10,21,0.323,6399,794,1898,0.418,593,1233,0.481,201,665,0.302,476,677,0.703,2265,2018,19
1686,UT-Martin,2010-11,33,12,21,0.364,6675,777,1836,0.423,596,1281,0.465,181,555,0.326,529,715,0.74,2264,2010,11
1687,SIU Edwardsville,2013-14,31,11,20,0.355,6225,806,1715,0.47,583,1125,0.518,223,590,0.378,429,645,0.665,2264,2013,14
1688,N.C. Central,2011-12,32,17,15,0.531,6400,772,1644,0.47,580,1105,0.525,192,539,0.356,527,746,0.706,2263,2011,12
1689,UCLA,2011-12,33,19,14,0.576,6600,848,1838,0.461,679,1385,0.49,169,453,0.373,398,596,0.668,2263,2011,12
1690,UC-Davis,2014-15,32,25,7,0.781,6475,775,1583,0.49,501,970,0.516,274,613,0.447,439,598,0.734,2263,2014,15
1691,Lamar,2015-16,30,11,19,0.367,6000,771,1819,0.424,574,1202,0.478,197,617,0.319,524,781,0.671,2263,2015,16
1692,UMass,2018-19,32,11,21,0.344,6450,808,1831,0.441,552,1099,0.502,256,732,0.35,391,574,0.681,2263,2018,19
1693,SMU,2010-11,35,20,15,0.571,7075,788,1634,0.482,511,931,0.549,277,703,0.394,409,551,0.742,2262,2010,11
1694,Buffalo,2011-12,31,20,11,0.645,6226,806,1734,0.465,594,1133,0.524,212,601,0.353,438,665,0.659,2262,2011,12
1695,UCSB,2011-12,31,20,11,0.645,6301,809,1757,0.46,582,1164,0.5,227,593,0.383,417,601,0.694,2262,2011,12
1696,Cincinnati,2012-13,34,22,12,0.647,6875,791,1963,0.403,561,1234,0.455,230,729,0.316,450,696,0.647,2262,2012,13
1697,Hampton,2013-14,31,18,13,0.581,6374,747,1781,0.419,576,1247,0.462,171,534,0.32,597,909,0.657,2262,2013,14
1698,Missouri State,2013-14,33,20,13,0.606,6677,761,1765,0.431,531,1120,0.474,230,645,0.357,510,720,0.708,2262,2013,14
1699,Oklahoma,2016-17,31,11,20,0.355,6325,788,1863,0.423,596,1305,0.457,192,558,0.344,494,685,0.721,2262,2016,17
1700,FIU,2017-18,32,14,18,0.438,6550,815,1912,0.426,612,1280,0.478,203,632,0.321,429,704,0.609,2262,2017,18
,,,,,,,,School,School,School,School,School,School,School,School,School,School,School,School,School,,
,Schl,Season,G,W,L,W-L%,MP,FG,FGA,FG%,2P,2PA,2P%,3P,3PA,3P%,FT,FTA,FT%,PTS,Season,
1701,Northern Ariz.,2018-19,31,10,21,0.323,6250,785,1819,0.432,526,1070,0.492,259,749,0.346,433,614,0.705,2262,2018,19
1702,Chattanooga,2011-12,32,11,21,0.344,6475,765,1849,0.414,525,1126,0.466,240,723,0.332,490,714,0.686,2260,2011,12
1703,Oklahoma,2012-13,32,20,12,0.625,6450,803,1847,0.435,644,1354,0.476,159,493,0.323,495,654,0.757,2260,2012,13
1704,Hofstra,2013-14,33,10,23,0.303,6626,750,1788,0.419,521,1103,0.472,229,685,0.334,531,806,0.659,2260,2013,14
1705,San Diego State,2016-17,33,19,14,0.576,6625,782,1878,0.416,549,1142,0.481,233,736,0.317,463,663,0.698,2260,2016,17
1706,Southern Ill.,2016-17,33,17,16,0.515,6700,808,1866,0.433,633,1312,0.482,175,554,0.316,469,674,0.696,2260,2016,17
1707,St. Francis (NY),2017-18,31,13,18,0.419,6300,784,1889,0.415,513,1106,0.464,271,783,0.346,421,591,0.712,2260,2017,18
1708,Nicholls State,2018-19,31,14,17,0.452,6250,807,1914,0.422,483,1031,0.468,324,883,0.367,322,418,0.77,2260,2018,19
1709,NW St.,2011-12,32,16,16,0.5,6475,789,1852,0.426,596,1227,0.486,193,625,0.309,488,799,0.611,2259,2011,12
1710,Southern,2014-15,35,18,17,0.514,7051,801,1895,0.423,651,1411,0.461,150,484,0.31,507,775,0.654,2259,2014,15
1711,Manhattan,2016-17,32,10,22,0.313,6525,754,1813,0.416,545,1177,0.463,209,636,0.329,542,743,0.729,2259,2016,17
1712,Milwaukee,2017-18,33,16,17,0.485,6650,834,1872,0.446,599,1168,0.513,235,704,0.334,356,528,0.674,2259,2017,18
1713,Georgetown,2010-11,32,21,11,0.656,6426,809,1703,0.475,586,1072,0.547,223,631,0.353,417,568,0.734,2258,2010,11
1714,USC,2013-14,32,11,21,0.344,6476,801,1824,0.439,655,1323,0.495,146,501,0.291,510,761,0.67,2258,2013,14
1715,UCSB,2014-15,33,19,14,0.576,6724,806,1836,0.439,581,1234,0.471,225,602,0.374,421,572,0.736,2258,2014,15
1716,Bethune-Cookman,2015-16,32,14,18,0.438,6475,799,1932,0.414,550,1145,0.48,249,787,0.316,411,597,0.688,2258,2015,16
1717,Gardner-Webb,2017-18,32,14,18,0.438,6500,822,1850,0.444,586,1174,0.499,236,676,0.349,378,526,0.719,2258,2017,18
1718,Iowa State,2017-18,31,13,18,0.419,6250,817,1870,0.437,583,1217,0.479,234,653,0.358,390,557,0.7,2258,2017,18
1719,Notre Dame,2011-12,34,22,12,0.647,6900,781,1800,0.434,560,1135,0.493,221,665,0.332,474,673,0.704,2257,2011,12
1720,Murray State,2012-13,31,21,10,0.677,6300,776,1716,0.452,533,1015,0.525,243,701,0.347,462,669,0.691,2257,2012,13
1721,Grambling,2017-18,31,17,14,0.548,6250,777,1852,0.42,623,1382,0.451,154,470,0.328,547,769,0.711,2257,2017,18
1722,Illinois State,2018-19,33,17,16,0.515,6650,813,1887,0.431,569,1153,0.493,244,734,0.332,387,540,0.717,2257,2018,19
1723,Northern Iowa,2013-14,31,16,15,0.516,6250,762,1693,0.45,498,961,0.518,264,732,0.361,468,646,0.724,2256,2013,14
1724,Duquesne,2016-17,32,10,22,0.313,6400,785,1835,0.428,559,1158,0.483,226,677,0.334,460,680,0.676,2256,2016,17
1725,Tulsa,2010-11,32,19,13,0.594,6500,753,1717,0.439,539,1104,0.488,214,613,0.349,535,763,0.701,2255,2010,11
1726,Michigan,2011-12,34,24,10,0.706,6875,808,1777,0.455,532,989,0.538,276,788,0.35,363,503,0.722,2255,2011,12
1727,Stanford,2018-19,31,15,16,0.484,6225,808,1783,0.453,601,1130,0.532,207,653,0.317,432,643,0.672,2255,2018,19
1728,Texas A&M,2010-11,33,24,9,0.727,6700,758,1719,0.441,577,1185,0.487,181,534,0.339,557,799,0.697,2254,2010,11
1729,St. Bonaventure,2011-12,32,20,12,0.625,6475,770,1687,0.456,596,1183,0.504,174,504,0.345,540,710,0.761,2254,2011,12
1730,Weber State,2013-14,31,19,12,0.613,6300,732,1541,0.475,510,975,0.523,222,566,0.392,568,767,0.741,2254,2013,14
1731,Indiana State,2010-11,34,20,14,0.588,6900,769,1793,0.429,534,1144,0.467,235,649,0.362,480,676,0.71,2253,2010,11
1732,UCF,2013-14,31,13,18,0.419,6300,803,1831,0.439,588,1189,0.495,215,642,0.335,432,704,0.614,2253,2013,14
1733,Texas A&M,2018-19,32,14,18,0.438,6400,806,1842,0.438,602,1179,0.511,204,663,0.308,437,631,0.693,2253,2018,19
1734,USC,2010-11,34,19,15,0.559,6825,813,1832,0.444,609,1255,0.485,204,577,0.354,422,648,0.651,2252,2010,11
1735,Duquesne,2011-12,31,16,15,0.516,6225,806,1786,0.451,607,1192,0.509,199,594,0.335,441,660,0.668,2252,2011,12
1736,Purdue,2012-13,34,16,18,0.471,6850,838,1968,0.426,693,1515,0.457,145,453,0.32,431,660,0.653,2252,2012,13
1737,Green Bay,2014-15,33,24,9,0.727,6625,829,1808,0.459,688,1328,0.518,141,480,0.294,453,705,0.643,2252,2014,15
1738,Oral Roberts,2016-17,30,8,22,0.267,6050,810,1819,0.445,594,1231,0.483,216,588,0.367,416,548,0.759,2252,2016,17
1739,Valparaiso,2017-18,32,15,17,0.469,6400,781,1740,0.449,568,1117,0.509,213,623,0.342,477,674,0.708,2252,2017,18
1740,Albany (NY),2012-13,35,24,11,0.686,7025,761,1748,0.435,548,1173,0.467,213,575,0.37,516,700,0.737,2251,2012,13
1741,Western Caro.,2014-15,32,15,17,0.469,6525,799,1839,0.434,602,1263,0.477,197,576,0.342,456,651,0.7,2251,2014,15
1742,Fairfield,2016-17,31,16,15,0.516,6250,822,1859,0.442,560,1077,0.52,262,782,0.335,345,506,0.682,2251,2016,17
1743,NJIT,2016-17,31,11,20,0.355,6224,786,1857,0.423,528,1082,0.488,258,775,0.333,421,599,0.703,2251,2016,17
1744,UMKC,2017-18,32,10,22,0.313,6425,756,1859,0.407,472,1014,0.465,284,845,0.336,455,640,0.711,2251,2017,18
1745,North Texas,2011-12,32,18,14,0.563,6525,818,1885,0.434,659,1390,0.474,159,495,0.321,455,639,0.712,2250,2011,12
1746,Tennessee State,2011-12,33,20,13,0.606,6724,774,1772,0.437,571,1186,0.481,203,586,0.346,499,724,0.689,2250,2011,12
1747,Liberty,2013-14,32,11,21,0.344,6400,816,1781,0.458,636,1279,0.497,180,502,0.359,438,622,0.704,2250,2013,14
1748,Georgia,2014-15,33,21,12,0.636,6755,747,1730,0.432,563,1192,0.472,184,538,0.342,572,826,0.692,2250,2014,15
1749,UNLV,2014-15,33,18,15,0.545,6672,808,1816,0.445,572,1177,0.486,236,639,0.369,398,600,0.663,2250,2014,15
1750,Penn,2018-19,31,19,12,0.613,6325,821,1810,0.454,539,1007,0.535,282,803,0.351,326,511,0.638,2250,2018,19
1751,St. Bonaventure,2018-19,34,18,16,0.529,6924,821,1914,0.429,613,1279,0.479,208,635,0.328,400,539,0.742,2250,2018,19
1752,Canisius,2018-19,32,15,17,0.469,6475,798,1834,0.435,542,1043,0.52,256,791,0.324,398,575,0.692,2250,2018,19
1753,TCU,2014-15,33,18,15,0.545,6650,791,1809,0.437,641,1350,0.475,150,459,0.327,517,841,0.615,2249,2014,15
1754,New Orleans,2015-16,30,10,20,0.333,6025,763,1820,0.419,601,1340,0.449,162,480,0.338,561,816,0.688,2249,2015,16
1755,Miami (OH),2016-17,32,11,21,0.344,6450,787,1815,0.434,588,1168,0.503,199,647,0.308,476,689,0.691,2249,2016,17
1756,Coastal Caro.,2011-12,31,19,12,0.613,6250,853,1753,0.487,703,1313,0.535,150,440,0.341,392,582,0.674,2248,2011,12
1757,Virginia,2012-13,35,23,12,0.657,7025,818,1790,0.457,605,1237,0.489,213,553,0.385,399,565,0.706,2248,2012,13
1758,Virginia Tech,2012-13,32,13,19,0.406,6500,791,1857,0.426,609,1277,0.477,182,580,0.314,484,683,0.709,2248,2012,13
1759,Illinois,2013-14,35,20,15,0.571,7024,797,1941,0.411,587,1279,0.459,210,662,0.317,444,606,0.733,2248,2013,14
1760,Yale,2015-16,30,23,7,0.767,6025,795,1693,0.47,605,1170,0.517,190,523,0.363,468,699,0.67,2248,2015,16
1761,Indiana State,2017-18,31,13,18,0.419,6375,762,1803,0.423,492,1055,0.466,270,748,0.361,454,644,0.705,2248,2017,18
1762,NJIT,2017-18,30,14,16,0.467,6050,808,1803,0.448,572,1150,0.497,236,653,0.361,396,579,0.684,2248,2017,18
1763,Mercer,2018-19,31,11,20,0.355,6225,787,1746,0.451,559,1083,0.516,228,663,0.344,446,648,0.688,2248,2018,19
1764,Green Bay,2012-13,34,18,16,0.529,6851,777,1772,0.438,613,1285,0.477,164,487,0.337,529,705,0.75,2247,2012,13
1765,Georgia,2017-18,33,18,15,0.545,6700,767,1825,0.42,566,1193,0.474,201,632,0.318,512,732,0.699,2247,2017,18
1766,Central Mich.,2013-14,31,10,21,0.323,6300,766,1767,0.434,517,990,0.522,249,777,0.32,465,655,0.71,2246,2013,14
1767,Virginia,2016-17,34,23,11,0.676,6900,839,1823,0.46,607,1221,0.497,232,602,0.385,336,474,0.709,2246,2016,17
1768,Western Mich.,2018-19,32,8,24,0.25,6498,774,1822,0.425,546,1099,0.497,228,723,0.315,470,680,0.691,2246,2018,19
1769,Nevada,2010-11,32,13,19,0.406,6450,753,1782,0.423,543,1176,0.462,210,606,0.347,529,771,0.686,2245,2010,11
1770,Stony Brook,2012-13,33,25,8,0.758,6601,790,1779,0.444,597,1233,0.484,193,546,0.353,472,670,0.704,2245,2012,13
1771,Army,2012-13,31,16,15,0.516,6267,767,1723,0.445,517,1048,0.493,250,675,0.37,461,628,0.734,2245,2012,13
1772,Army,2013-14,31,15,16,0.484,6251,801,1804,0.444,565,1107,0.51,236,697,0.339,406,580,0.7,2244,2013,14
1773,North Dakota St.,2016-17,30,19,11,0.633,6075,775,1693,0.458,543,1063,0.511,232,630,0.368,462,650,0.711,2244,2016,17
1774,Dayton,2017-18,31,14,17,0.452,6300,804,1671,0.481,556,935,0.595,248,736,0.337,388,531,0.731,2244,2017,18
1775,Alcorn State,2017-18,32,11,21,0.344,6425,791,1824,0.434,552,1127,0.49,239,697,0.343,423,598,0.707,2244,2017,18
1776,Weber State,2010-11,32,18,14,0.563,6425,766,1707,0.449,510,1080,0.472,256,627,0.408,455,602,0.756,2243,2010,11
1777,Colorado State,2011-12,32,20,12,0.625,6475,764,1621,0.471,575,1148,0.501,189,473,0.4,526,685,0.768,2243,2011,12
1778,UConn,2014-15,35,20,15,0.571,7025,800,1824,0.439,574,1187,0.484,226,637,0.355,417,590,0.707,2243,2014,15
1779,Western Ky.,2010-11,32,16,16,0.5,6450,809,1855,0.436,630,1282,0.491,179,573,0.312,445,693,0.642,2242,2010,11
1780,Lipscomb,2011-12,31,13,18,0.419,6300,802,1852,0.433,567,1215,0.467,235,637,0.369,403,634,0.636,2242,2011,12
1781,Northern Colo.,2014-15,30,15,15,0.5,6099,804,1691,0.475,600,1156,0.519,204,535,0.381,430,602,0.714,2242,2014,15
1782,UNC Asheville,2014-15,31,15,16,0.484,6224,780,1774,0.44,547,1122,0.488,233,652,0.357,449,619,0.725,2242,2014,15
1783,Bethune-Cookman,2010-11,34,21,13,0.618,6950,796,1814,0.439,656,1371,0.478,140,443,0.316,509,719,0.708,2241,2010,11
1784,Air Force,2012-13,32,18,14,0.563,6426,795,1690,0.47,523,978,0.535,272,712,0.382,379,531,0.714,2241,2012,13
1785,Tulsa,2012-13,33,17,16,0.515,6675,763,1760,0.434,562,1162,0.484,201,598,0.336,514,767,0.67,2241,2012,13
1786,N.C. A&T,2018-19,32,19,13,0.594,6449,825,1797,0.459,598,1148,0.521,227,649,0.35,364,548,0.664,2241,2018,19
1787,Hawaii,2018-19,31,18,13,0.581,6250,788,1746,0.451,522,995,0.525,266,751,0.354,399,576,0.693,2241,2018,19
1788,Coppin State,2015-16,31,9,22,0.29,6400,741,1933,0.383,503,1218,0.413,238,715,0.333,520,737,0.706,2240,2015,16
1789,Tulane,2015-16,34,12,22,0.353,6950,802,2021,0.397,586,1302,0.45,216,719,0.3,420,621,0.676,2240,2015,16
1790,Montana,2011-12,32,25,7,0.781,6425,781,1689,0.462,586,1165,0.503,195,524,0.372,482,672,0.717,2239,2011,12
1791,Albany (NY),2013-14,34,19,15,0.559,6876,765,1733,0.441,602,1280,0.47,163,453,0.36,546,728,0.75,2239,2013,14
1792,UNC Wilmington,2014-15,32,18,14,0.563,6475,810,1834,0.442,648,1369,0.473,162,465,0.348,457,677,0.675,2239,2014,15
1793,Kennesaw State,2015-16,31,11,20,0.355,6225,811,1826,0.444,632,1318,0.48,179,508,0.352,438,625,0.701,2239,2015,16
1794,Marist,2017-18,31,6,25,0.194,6300,761,1710,0.445,481,908,0.53,280,802,0.349,437,612,0.714,2239,2017,18
1795,Norfolk State,2010-11,32,12,20,0.375,6500,782,1791,0.437,606,1217,0.498,176,574,0.307,498,735,0.678,2238,2010,11
1796,Montana,2012-13,32,25,7,0.781,6525,760,1635,0.465,541,1046,0.517,219,589,0.372,499,651,0.767,2238,2012,13
1797,Lafayette,2010-11,32,13,19,0.406,6575,754,1757,0.429,507,1052,0.482,247,705,0.35,482,633,0.761,2237,2010,11
1798,N.C. A&T,2011-12,32,12,20,0.375,6476,778,1852,0.42,554,1185,0.468,224,667,0.336,456,698,0.653,2236,2011,12
1799,NJIT,2011-12,32,15,17,0.469,6500,787,1861,0.423,529,1129,0.469,258,732,0.352,404,575,0.703,2236,2011,12
1800,Gardner-Webb,2012-13,34,21,13,0.618,6924,791,1871,0.423,601,1288,0.467,190,583,0.326,464,649,0.715,2236,2012,13
,,,,,,,,School,School,School,School,School,School,School,School,School,School,School,School,School,,
,Schl,Season,G,W,L,W-L%,MP,FG,FGA,FG%,2P,2PA,2P%,3P,3PA,3P%,FT,FTA,FT%,PTS,Season,
1801,CS Long Beach,2013-14,32,15,17,0.469,6476,822,1904,0.432,631,1291,0.489,191,613,0.312,401,607,0.661,2236,2013,14
1802,Texas A&M,2014-15,33,21,12,0.636,6649,805,1778,0.453,624,1257,0.496,181,521,0.347,445,676,0.658,2236,2014,15
1803,Kansas State,2018-19,34,25,9,0.735,6800,806,1878,0.429,565,1157,0.488,241,721,0.334,383,574,0.667,2236,2018,19
1804,Longwood,2013-14,32,8,24,0.25,6401,812,1845,0.44,632,1332,0.474,180,513,0.351,431,591,0.729,2235,2013,14
1805,La.-Monroe,2017-18,32,16,16,0.5,6450,811,1863,0.435,523,1062,0.492,288,801,0.36,325,453,0.717,2235,2017,18
1806,Miss. St.,2013-14,33,14,19,0.424,6650,785,1776,0.442,631,1274,0.495,154,502,0.307,510,769,0.663,2234,2013,14
1807,Northeastern,2016-17,31,15,16,0.484,6275,767,1682,0.456,500,954,0.524,267,728,0.367,433,636,0.681,2234,2016,17
1808,Evansville,2018-19,32,11,21,0.344,6475,747,1776,0.421,483,1000,0.483,264,776,0.34,476,660,0.721,2234,2018,19
1809,Wright State,2012-13,36,23,13,0.639,7251,801,1826,0.439,597,1224,0.488,204,602,0.339,427,607,0.703,2233,2012,13
1810,Mt. St. Mary's,2012-13,32,18,14,0.563,6424,778,1813,0.429,504,1002,0.503,274,811,0.338,403,578,0.697,2233,2012,13
1811,Miss Val St,2016-17,32,7,25,0.219,6475,818,1942,0.421,644,1434,0.449,174,508,0.343,423,651,0.65,2233,2016,17
1812,Cal St Northridge,2010-11,32,14,18,0.438,6400,752,1725,0.436,576,1183,0.487,176,542,0.325,552,820,0.673,2232,2010,11
1813,Chicago State,2013-14,32,13,19,0.406,6526,787,1884,0.418,567,1231,0.461,220,653,0.337,438,649,0.675,2232,2013,14
1814,Lipscomb,2014-15,31,14,17,0.452,6275,741,1769,0.419,488,999,0.488,253,770,0.329,497,715,0.695,2232,2014,15
1815,Rhode Island,2014-15,33,23,10,0.697,6625,777,1732,0.449,631,1250,0.505,146,482,0.303,532,812,0.655,2232,2014,15
1816,Charleston So.,2017-18,31,15,16,0.484,6300,802,1793,0.447,594,1162,0.511,208,631,0.33,420,581,0.723,2232,2017,18
1817,Old Dominion,2010-11,34,27,7,0.794,6800,803,1828,0.439,637,1323,0.481,166,505,0.329,459,687,0.668,2231,2010,11
1818,UNC Greensboro,2011-12,32,13,19,0.406,6450,791,1961,0.403,569,1305,0.436,222,656,0.338,427,623,0.685,2231,2011,12
1819,Coppin State,2013-14,32,12,20,0.375,6424,722,1840,0.392,487,1115,0.437,235,725,0.324,552,756,0.73,2231,2013,14
1820,Jacksonville,2013-14,30,12,18,0.4,6000,756,1729,0.437,568,1176,0.483,188,553,0.34,531,749,0.709,2231,2013,14
1821,Loyola (IL),2018-19,34,20,14,0.588,6800,831,1687,0.493,625,1124,0.556,206,563,0.366,363,545,0.666,2231,2018,19
1822,Fort Wayne,2010-11,30,18,12,0.6,6050,766,1676,0.457,526,1052,0.5,240,624,0.385,458,593,0.772,2230,2010,11
1823,Colorado,2012-13,33,21,12,0.636,6700,775,1788,0.433,597,1271,0.47,178,517,0.344,502,732,0.686,2230,2012,13
1824,Navy,2015-16,33,19,14,0.576,6700,805,1769,0.455,664,1299,0.511,141,470,0.3,479,748,0.64,2230,2015,16
1825,Army,2017-18,30,13,17,0.433,6026,820,1845,0.444,525,1074,0.489,295,771,0.383,295,448,0.658,2230,2017,18
1826,Eastern Ky.,2017-18,31,11,20,0.355,6225,778,1779,0.437,552,1141,0.484,226,638,0.354,448,600,0.747,2230,2017,18
1827,DePaul,2017-18,31,11,20,0.355,6222,819,1912,0.428,625,1286,0.486,194,626,0.31,398,562,0.708,2230,2017,18
1828,Charlotte,2012-13,33,21,12,0.636,6650,793,1804,0.44,679,1379,0.492,114,425,0.268,529,809,0.654,2229,2012,13
1829,Texas,2012-13,34,16,18,0.471,6975,776,1880,0.413,604,1300,0.465,172,580,0.297,505,766,0.659,2229,2012,13
1830,Md.-East. Shore,2014-15,33,18,15,0.545,6626,752,1660,0.453,539,1103,0.489,213,557,0.382,512,781,0.656,2229,2014,15
1831,Indiana,2017-18,31,16,15,0.516,6275,806,1767,0.456,612,1165,0.525,194,602,0.322,423,644,0.657,2229,2017,18
1832,Penn State,2018-19,32,14,18,0.438,6475,791,1898,0.417,569,1205,0.472,222,693,0.32,425,613,0.693,2229,2018,19
1833,Kent State,2013-14,32,16,16,0.5,6449,766,1787,0.429,534,1117,0.478,232,670,0.346,464,660,0.703,2228,2013,14
1834,North Texas,2013-14,32,16,16,0.5,6476,774,1845,0.42,617,1369,0.451,157,476,0.33,523,769,0.68,2228,2013,14
1835,South Alabama,2017-18,32,14,18,0.438,6425,752,1785,0.421,500,1006,0.497,252,779,0.323,472,674,0.7,2228,2017,18
1836,Indiana,2010-11,32,12,20,0.375,6425,789,1713,0.461,600,1167,0.514,189,546,0.346,459,632,0.726,2226,2010,11
1837,San Diego State,2014-15,36,27,9,0.75,7276,800,1916,0.418,611,1325,0.461,189,591,0.32,437,694,0.63,2226,2014,15
1838,Omaha,2014-15,29,12,17,0.414,5850,767,1724,0.445,588,1185,0.496,179,539,0.332,513,737,0.696,2226,2014,15
1839,Loyola Marymount,2017-18,31,11,20,0.355,6250,803,1813,0.443,603,1239,0.487,200,574,0.348,421,593,0.71,2226,2017,18
1840,Dayton,2012-13,31,17,14,0.548,6250,786,1656,0.475,604,1182,0.511,182,474,0.384,471,657,0.717,2225,2012,13
1841,Quinnipiac,2012-13,31,15,16,0.484,6326,789,1844,0.428,652,1435,0.454,137,409,0.335,510,758,0.673,2225,2012,13
1842,George Washington,2017-18,33,15,18,0.455,6600,832,1861,0.447,652,1300,0.502,180,561,0.321,381,537,0.709,2225,2017,18
1843,Fordham,2013-14,31,10,21,0.323,6225,764,1942,0.393,544,1223,0.445,220,719,0.306,476,649,0.733,2224,2013,14
1844,Virginia,2014-15,34,30,4,0.882,6850,804,1758,0.457,634,1275,0.497,170,483,0.352,446,614,0.726,2224,2014,15
1845,Fla. Gulf Coast,2014-15,33,22,11,0.667,6624,814,1883,0.432,617,1298,0.475,197,585,0.337,399,603,0.662,2224,2014,15
1846,NW St.,2015-16,28,8,20,0.286,5600,770,1688,0.456,563,1110,0.507,207,578,0.358,477,623,0.766,2224,2015,16
1847,Southeastern LA,2018-19,33,17,16,0.515,6600,765,1735,0.441,530,1039,0.51,235,696,0.338,459,640,0.717,2224,2018,19
1848,Southern,2012-13,33,23,10,0.697,6599,761,1757,0.433,535,1138,0.47,226,619,0.365,475,689,0.689,2223,2012,13
1849,Marist,2016-17,32,8,24,0.25,6450,749,1747,0.429,504,1011,0.499,245,736,0.333,480,662,0.725,2223,2016,17
1850,Bradley,2017-18,33,20,13,0.606,6600,768,1788,0.43,551,1175,0.469,217,613,0.354,470,665,0.707,2223,2017,18
1851,Loyola (MD),2011-12,33,24,9,0.727,6600,755,1775,0.425,591,1291,0.458,164,484,0.339,548,762,0.719,2222,2011,12
1852,UNC Greensboro,2012-13,31,9,22,0.29,6200,788,1886,0.418,561,1221,0.459,227,665,0.341,419,623,0.673,2222,2012,13
1853,North Dakota,2012-13,33,16,17,0.485,6625,776,1833,0.423,569,1230,0.463,207,603,0.343,463,651,0.711,2222,2012,13
1854,N.C. Central,2015-16,32,13,19,0.406,6436,780,1807,0.432,580,1231,0.471,200,576,0.347,462,697,0.663,2222,2015,16
1855,Harvard,2018-19,31,19,12,0.613,6327,787,1711,0.46,527,989,0.533,260,722,0.36,388,538,0.721,2222,2018,19
1856,High Point,2012-13,31,17,14,0.548,6250,823,1841,0.447,685,1399,0.49,138,442,0.312,437,609,0.718,2221,2012,13
1857,Creighton,2014-15,33,14,19,0.424,6700,746,1776,0.42,484,1017,0.476,262,759,0.345,467,644,0.725,2221,2014,15
1858,UMass-Lowell,2015-16,29,11,18,0.379,5850,800,1705,0.469,560,1046,0.535,240,659,0.364,381,556,0.685,2221,2015,16
1859,Alcorn State,2016-17,32,18,14,0.563,6426,800,1866,0.429,578,1197,0.483,222,669,0.332,399,612,0.652,2221,2016,17
1860,Portland,2017-18,32,10,22,0.313,6450,781,1745,0.448,526,1080,0.487,255,665,0.383,404,596,0.678,2221,2017,18
1861,Mercer,2010-11,33,15,18,0.455,6676,738,1766,0.418,526,1124,0.468,212,642,0.33,532,771,0.69,2220,2010,11
1862,TCU,2010-11,33,11,22,0.333,6632,821,1883,0.436,607,1271,0.478,214,612,0.35,364,540,0.674,2220,2010,11
1863,Texas-Arlington,2014-15,31,16,15,0.516,6225,779,1773,0.439,574,1125,0.51,205,648,0.316,457,679,0.673,2220,2014,15
1864,DePaul,2014-15,32,12,20,0.375,6425,757,1739,0.435,509,1034,0.492,248,705,0.352,458,635,0.721,2220,2014,15
1865,UMass,2014-15,32,17,15,0.531,6450,772,1785,0.432,628,1297,0.484,144,488,0.295,532,756,0.704,2220,2014,15
1866,Rhode Island,2015-16,32,17,15,0.531,6475,782,1762,0.444,569,1178,0.483,213,584,0.365,443,662,0.669,2220,2015,16
1867,UConn,2016-17,33,16,17,0.485,6650,778,1809,0.43,555,1181,0.47,223,628,0.355,441,619,0.712,2220,2016,17
1868,North Dakota,2018-19,30,12,18,0.4,6000,822,1771,0.464,581,1124,0.517,241,647,0.372,335,482,0.695,2220,2018,19
1869,UMKC,2018-19,32,11,21,0.344,6450,774,1794,0.431,515,1066,0.483,259,728,0.356,413,590,0.7,2220,2018,19
1870,Coppin State,2014-15,31,8,23,0.258,6200,758,1906,0.398,463,1080,0.429,295,826,0.357,408,590,0.692,2219,2014,15
1871,Middle Tenn.,2010-11,32,16,16,0.5,6525,733,1719,0.426,565,1227,0.46,168,492,0.341,584,823,0.71,2218,2010,11
1872,Austin Peay,2012-13,31,8,23,0.258,6324,783,1714,0.457,557,1124,0.496,226,590,0.383,426,633,0.673,2218,2012,13
1873,California,2012-13,33,21,12,0.636,6624,833,1875,0.444,699,1432,0.488,134,443,0.302,418,585,0.715,2218,2012,13
1874,Chattanooga,2012-13,32,13,19,0.406,6450,762,1822,0.418,595,1261,0.472,167,561,0.298,527,793,0.665,2218,2012,13
1875,Mt. St. Mary's,2015-16,33,14,19,0.424,6675,788,1967,0.401,562,1254,0.448,226,713,0.317,416,601,0.692,2218,2015,16
1876,Wagner,2013-14,31,19,12,0.613,6251,776,1849,0.42,607,1344,0.452,169,505,0.335,496,679,0.73,2217,2013,14
1877,James Madison,2014-15,33,19,14,0.576,6626,748,1660,0.451,520,1047,0.497,228,613,0.372,493,700,0.704,2217,2014,15
1878,Sacred Heart,2015-16,30,12,18,0.4,6073,785,1795,0.437,616,1251,0.492,169,544,0.311,478,695,0.688,2217,2015,16
1879,Alabama State,2015-16,31,14,17,0.452,6301,788,1918,0.411,573,1271,0.451,215,647,0.332,426,623,0.684,2217,2015,16
1880,Northern Ariz.,2016-17,32,9,23,0.281,6425,769,1892,0.406,530,1146,0.462,239,746,0.32,440,644,0.683,2217,2016,17
1881,UTEP,2016-17,32,15,17,0.469,6500,812,1731,0.469,632,1214,0.521,180,517,0.348,413,624,0.662,2217,2016,17
1882,Hawaii,2010-11,32,19,13,0.594,6475,760,1685,0.451,567,1144,0.496,193,541,0.357,503,734,0.685,2216,2010,11
1883,Austin Peay,2011-12,32,12,20,0.375,6450,792,1781,0.445,653,1348,0.484,139,433,0.321,493,735,0.671,2216,2011,12
1884,Northern Iowa,2011-12,34,20,14,0.588,6800,754,1752,0.43,487,1061,0.459,267,691,0.386,441,605,0.729,2216,2011,12
1885,Incarnate Word,2013-14,27,21,6,0.778,5425,771,1581,0.488,568,1059,0.536,203,522,0.389,471,688,0.685,2216,2013,14
1886,Samford,2014-15,32,13,19,0.406,6426,780,1756,0.444,576,1168,0.493,204,588,0.347,452,661,0.684,2216,2014,15
1887,Rutgers,2017-18,34,15,19,0.441,6875,830,2042,0.406,685,1542,0.444,145,500,0.29,409,635,0.644,2216,2017,18
1888,Holy Cross,2018-19,33,16,17,0.485,6675,848,1834,0.462,611,1164,0.525,237,670,0.354,283,424,0.667,2216,2018,19
1889,SE Missouri St,2018-19,31,10,21,0.323,6325,796,1809,0.44,530,1090,0.486,266,719,0.37,358,519,0.69,2216,2018,19
1890,Princeton,2010-11,32,25,7,0.781,6525,788,1696,0.465,595,1165,0.511,193,531,0.363,446,609,0.732,2215,2010,11
1891,Omaha,2012-13,31,11,20,0.355,6200,826,1786,0.462,637,1258,0.506,189,528,0.358,374,536,0.698,2215,2012,13
1892,San Diego,2012-13,34,16,18,0.471,6850,782,1796,0.435,579,1214,0.477,203,582,0.349,448,663,0.676,2215,2012,13
1893,Boston College,2012-13,33,16,17,0.485,6625,750,1701,0.441,516,1039,0.497,234,662,0.353,481,676,0.712,2215,2012,13
1894,Charlotte,2013-14,31,17,14,0.548,6250,788,1771,0.445,602,1248,0.482,186,523,0.356,453,699,0.648,2215,2013,14
1895,Utah State,2013-14,32,18,14,0.563,6451,782,1732,0.452,562,1190,0.472,220,542,0.406,431,587,0.734,2215,2013,14
1896,Cal St Bakersfield,2013-14,32,13,19,0.406,6450,767,1752,0.438,546,1184,0.461,221,568,0.389,460,669,0.688,2215,2013,14
1897,Morgan State,2013-14,31,15,16,0.484,6324,800,1869,0.428,660,1333,0.495,140,536,0.261,475,776,0.612,2215,2013,14
1898,San Francisco,2014-15,32,14,18,0.438,6450,783,1735,0.451,580,1139,0.509,203,596,0.341,446,709,0.629,2215,2014,15
1899,Portland,2016-17,33,11,22,0.333,6675,758,1793,0.423,544,1220,0.446,214,573,0.373,485,655,0.74,2215,2016,17
1900,Texas,2016-17,33,11,22,0.333,6601,810,1846,0.439,629,1227,0.513,181,619,0.292,414,637,0.65,2215,2016,17
,,,,,,,,School,School,School,School,School,School,School,School,School,School,School,School,School,,
,Schl,Season,G,W,L,W-L%,MP,FG,FGA,FG%,2P,2PA,2P%,3P,3PA,3P%,FT,FTA,FT%,PTS,Season,
1901,Northern Iowa,2018-19,34,16,18,0.471,6800,769,1847,0.416,493,1055,0.467,276,792,0.348,401,537,0.747,2215,2018,19
1902,Abilene Christ.,2013-14,31,11,20,0.355,6275,737,1664,0.443,496,1065,0.466,241,599,0.402,499,666,0.749,2214,2013,14
1903,Coppin State,2011-12,30,14,16,0.467,6025,756,1749,0.432,467,957,0.488,289,792,0.365,412,596,0.691,2213,2011,12
1904,Fort Wayne,2012-13,33,16,17,0.485,6700,777,1771,0.439,555,1151,0.482,222,620,0.358,437,681,0.642,2213,2012,13
1905,Duquesne,2014-15,31,12,19,0.387,6225,803,1788,0.449,558,1125,0.496,245,663,0.37,362,577,0.627,2213,2014,15
1906,Stony Brook,2016-17,32,18,14,0.563,6400,759,1878,0.404,509,1114,0.457,250,764,0.327,445,617,0.721,2213,2016,17
1907,Missouri,2016-17,32,8,24,0.25,6450,744,1893,0.393,519,1154,0.45,225,739,0.304,500,732,0.683,2213,2016,17
1908,Lafayette,2013-14,31,11,20,0.355,6250,781,1661,0.47,550,1081,0.509,231,580,0.398,419,563,0.744,2212,2013,14
1909,Incarnate Word,2016-17,29,12,17,0.414,5825,736,1617,0.455,503,1016,0.495,233,601,0.388,507,731,0.694,2212,2016,17
1910,App. St.,2012-13,31,15,16,0.484,6350,777,1781,0.436,576,1221,0.472,201,560,0.359,456,662,0.689,2211,2012,13
1911,Citadel,2013-14,33,7,26,0.212,6649,764,1778,0.43,554,1196,0.463,210,582,0.361,473,655,0.722,2211,2013,14
1912,Prairie View,2014-15,33,15,18,0.455,6600,822,1923,0.427,645,1391,0.464,177,532,0.333,390,604,0.646,2211,2014,15
1913,Idaho State,2017-18,30,14,16,0.467,6000,778,1639,0.475,526,1002,0.525,252,637,0.396,403,594,0.678,2211,2017,18
1914,UC-Davis,2012-13,31,14,17,0.452,6226,781,1651,0.473,524,1016,0.516,257,635,0.405,391,544,0.719,2210,2012,13
1915,FIU,2012-13,32,18,14,0.563,6400,766,1794,0.427,542,1122,0.483,224,672,0.333,454,642,0.707,2210,2012,13
1916,Sacramento St.,2015-16,31,14,17,0.452,6225,790,1784,0.443,581,1166,0.498,209,618,0.338,421,627,0.671,2210,2015,16
1917,Murray State,2015-16,31,17,14,0.548,6225,770,1694,0.455,544,1073,0.507,226,621,0.364,444,613,0.724,2210,2015,16
1918,Oklahoma State,2011-12,33,15,18,0.455,6675,746,1756,0.425,535,1123,0.476,211,633,0.333,506,685,0.739,2209,2011,12
1919,Yale,2013-14,33,19,14,0.576,6630,721,1725,0.418,546,1193,0.458,175,532,0.329,592,853,0.694,2209,2013,14
1920,Wake Forest,2014-15,32,13,19,0.406,6475,762,1809,0.421,556,1195,0.465,206,614,0.336,479,751,0.638,2209,2014,15
1921,Abilene Christ.,2015-16,31,13,18,0.419,6250,771,1704,0.452,562,1134,0.496,209,570,0.367,458,653,0.701,2209,2015,16
1922,TCU,2015-16,33,12,21,0.364,6600,734,1810,0.406,547,1252,0.437,187,558,0.335,554,826,0.671,2209,2015,16
1923,Western Ky.,2016-17,32,15,17,0.469,6400,777,1767,0.44,563,1161,0.485,214,606,0.353,441,657,0.671,2209,2016,17
1924,Lafayette,2018-19,30,10,20,0.333,6099,802,1786,0.449,522,1050,0.497,280,736,0.38,325,437,0.744,2209,2018,19
1925,Cal St Fullerton,2010-11,31,11,20,0.355,6225,752,1675,0.449,554,1135,0.488,198,540,0.367,506,704,0.719,2208,2010,11
1926,North Florida,2010-11,34,15,19,0.441,6899,758,1741,0.435,555,1125,0.493,203,616,0.33,489,740,0.661,2208,2010,11
1927,Houston Baptist,2011-12,30,10,20,0.333,6050,787,1860,0.423,634,1381,0.459,153,479,0.319,481,704,0.683,2208,2011,12
1928,Marshall,2012-13,32,13,19,0.406,6450,767,1796,0.427,569,1150,0.495,198,646,0.307,476,796,0.598,2208,2012,13
1929,Monmouth,2013-14,32,11,21,0.344,6475,776,1847,0.42,599,1320,0.454,177,527,0.336,479,749,0.64,2208,2013,14
1930,Southern Ill.,2013-14,33,14,19,0.424,6624,781,1717,0.455,633,1268,0.499,148,449,0.33,498,741,0.672,2208,2013,14
1931,Loyola Marymount,2015-16,31,14,17,0.452,6330,796,1903,0.418,569,1234,0.461,227,669,0.339,389,536,0.726,2208,2015,16
1932,Drake,2016-17,31,7,24,0.226,6274,760,1856,0.409,490,1074,0.456,270,782,0.345,418,553,0.756,2208,2016,17
1933,App. St.,2016-17,30,9,21,0.3,6025,749,1781,0.421,498,1039,0.479,251,742,0.338,459,674,0.681,2208,2016,17
1934,McNeese State,2011-12,33,17,16,0.515,6625,804,1904,0.422,631,1365,0.462,173,539,0.321,426,631,0.675,2207,2011,12
1935,Richmond,2011-12,32,16,16,0.5,6425,724,1693,0.428,474,994,0.477,250,699,0.358,509,667,0.763,2207,2011,12
1936,St. Francis (NY),2013-14,32,18,14,0.563,6474,781,1813,0.431,586,1194,0.491,195,619,0.315,450,659,0.683,2207,2013,14
1937,Campbell,2015-16,30,12,18,0.4,6027,744,1671,0.445,520,996,0.522,224,675,0.332,495,690,0.717,2207,2015,16
1938,Lafayette,2017-18,31,10,21,0.323,6225,777,1709,0.455,514,1001,0.513,263,708,0.371,390,507,0.769,2207,2017,18
1939,Delaware,2011-12,32,18,14,0.563,6525,746,1750,0.426,577,1207,0.478,169,543,0.311,545,760,0.717,2206,2011,12
1940,Pepperdine,2013-14,31,15,16,0.484,6226,773,1701,0.454,576,1150,0.501,197,551,0.358,463,661,0.7,2206,2013,14
1941,Fordham,2015-16,31,17,14,0.548,6274,782,1744,0.448,539,1042,0.517,243,702,0.346,399,586,0.681,2206,2015,16
1942,Pacific,2016-17,33,11,22,0.333,6625,784,1939,0.404,599,1379,0.434,185,560,0.33,453,671,0.675,2206,2016,17
1943,DePaul,2016-17,32,9,23,0.281,6425,775,1804,0.43,591,1240,0.477,184,564,0.326,472,642,0.735,2206,2016,17
1944,Wisconsin,2017-18,33,15,18,0.455,6625,793,1770,0.448,577,1126,0.512,216,644,0.335,404,578,0.699,2206,2017,18
1945,Missouri State,2018-19,32,16,16,0.5,6425,774,1714,0.452,550,1065,0.516,224,649,0.345,434,627,0.692,2206,2018,19
1946,Wofford,2013-14,33,20,13,0.606,6626,808,1804,0.448,612,1260,0.486,196,544,0.36,393,592,0.664,2205,2013,14
1947,Stony Brook,2017-18,32,13,19,0.406,6450,779,1866,0.417,530,1109,0.478,249,757,0.329,398,606,0.657,2205,2017,18
1948,Central Conn St,2018-19,31,11,20,0.355,6300,754,1821,0.414,553,1209,0.457,201,612,0.328,496,634,0.782,2205,2018,19
1949,Valparaiso,2018-19,33,15,18,0.455,6675,802,1783,0.45,617,1198,0.515,185,585,0.316,416,595,0.699,2205,2018,19
1950,UNC Greensboro,2010-11,31,7,24,0.226,6275,780,1820,0.429,594,1298,0.458,186,522,0.356,458,664,0.69,2204,2010,11
1951,Sacramento St.,2016-17,31,13,18,0.419,6301,808,1759,0.459,648,1253,0.517,160,506,0.316,428,657,0.651,2204,2016,17
1952,Santa Clara,2016-17,33,17,16,0.515,6700,778,1784,0.436,460,952,0.483,318,832,0.382,330,451,0.732,2204,2016,17
1953,NW St.,2016-17,29,13,16,0.448,5850,751,1698,0.442,548,1143,0.479,203,555,0.366,499,723,0.69,2204,2016,17
1954,High Point,2011-12,31,13,18,0.419,6300,746,1698,0.439,483,1042,0.464,263,656,0.401,448,654,0.685,2203,2011,12
1955,Providence,2011-12,32,15,17,0.469,6425,772,1806,0.427,614,1359,0.452,158,447,0.353,501,712,0.704,2203,2011,12
1956,High Point,2013-14,31,16,15,0.516,6225,801,1698,0.472,614,1213,0.506,187,485,0.386,414,558,0.742,2203,2013,14
1957,Northwestern,2017-18,32,15,17,0.469,6450,773,1813,0.426,518,1093,0.474,255,720,0.354,402,538,0.747,2203,2017,18
1958,Eastern Mich.,2018-19,32,15,17,0.469,6475,818,1823,0.449,631,1189,0.531,187,634,0.295,380,604,0.629,2203,2018,19
1959,Loyola Marymount,2012-13,34,11,23,0.324,6875,769,1915,0.402,571,1316,0.434,198,599,0.331,466,663,0.703,2202,2012,13
1960,UNLV,2016-17,32,11,21,0.344,6475,747,1893,0.395,534,1227,0.435,213,666,0.32,495,711,0.696,2202,2016,17
1961,Liberty,2011-12,32,14,18,0.438,6425,811,1790,0.453,686,1395,0.492,125,395,0.316,454,637,0.713,2201,2011,12
1962,UIC,2014-15,34,10,24,0.294,6821,724,1870,0.387,520,1241,0.419,204,629,0.324,549,745,0.737,2201,2014,15
1963,ETSU,2014-15,30,16,14,0.533,6050,722,1712,0.422,442,948,0.466,280,764,0.366,477,661,0.722,2201,2014,15
1964,Georgia Tech,2013-14,33,16,17,0.485,6674,796,1847,0.431,623,1298,0.48,173,549,0.315,435,636,0.684,2200,2013,14
1965,Duquesne,2013-14,30,13,17,0.433,6000,751,1699,0.442,533,1099,0.485,218,600,0.363,480,717,0.669,2200,2013,14
1966,Texas A&M,2013-14,34,18,16,0.529,6925,774,1821,0.425,577,1200,0.481,197,621,0.317,454,707,0.642,2199,2013,14
1967,Navy,2017-18,32,20,12,0.625,6425,771,1737,0.444,565,1115,0.507,206,622,0.331,451,627,0.719,2199,2017,18
1968,Arkansas State,2011-12,34,14,20,0.412,6850,765,1771,0.432,589,1295,0.455,176,476,0.37,492,737,0.668,2198,2011,12
1969,Maryland,2011-12,32,17,15,0.531,6475,743,1747,0.425,570,1237,0.461,173,510,0.339,539,812,0.664,2198,2011,12
1970,Grand Canyon,2014-15,32,17,15,0.531,6404,759,1683,0.451,561,1089,0.515,198,594,0.333,482,674,0.715,2198,2014,15
1971,La.-Monroe,2016-17,33,9,24,0.273,6750,814,1916,0.425,577,1203,0.48,237,713,0.332,333,498,0.669,2198,2016,17
1972,Western Ill.,2018-19,31,10,21,0.323,6225,818,1860,0.44,577,1234,0.468,241,626,0.385,321,440,0.73,2198,2018,19
1973,Idaho State,2018-19,30,11,19,0.367,6000,779,1742,0.447,505,990,0.51,274,752,0.364,366,498,0.735,2198,2018,19
1974,Hampton,2010-11,33,24,9,0.727,6700,746,1843,0.405,533,1185,0.45,213,658,0.324,492,759,0.648,2197,2010,11
1975,Boston College,2013-14,32,8,24,0.25,6524,716,1606,0.446,469,904,0.519,247,702,0.352,518,699,0.741,2197,2013,14
1976,Florida State,2014-15,33,17,16,0.515,6650,763,1669,0.457,616,1199,0.514,147,470,0.313,524,783,0.669,2197,2014,15
1977,Eastern Ky.,2016-17,31,12,19,0.387,6325,750,1751,0.428,515,1018,0.506,235,733,0.321,462,655,0.705,2197,2016,17
1978,Sacramento St.,2018-19,31,15,16,0.484,6250,806,1800,0.448,631,1273,0.496,175,527,0.332,410,592,0.693,2197,2018,19
1979,Richmond,2013-14,33,19,14,0.576,6699,750,1777,0.422,541,1128,0.48,209,649,0.322,487,728,0.669,2196,2013,14
1980,Boston College,2018-19,31,14,17,0.452,6294,768,1808,0.425,550,1121,0.491,218,687,0.317,442,633,0.698,2196,2018,19
1981,California,2014-15,33,18,15,0.545,6649,821,1868,0.44,636,1353,0.47,185,515,0.359,368,567,0.649,2195,2014,15
1982,San Jose State,2016-17,30,14,16,0.467,6025,772,1750,0.441,572,1176,0.486,200,574,0.348,451,643,0.701,2195,2016,17
1983,Murray State,2010-11,32,23,9,0.719,6400,737,1606,0.459,545,1100,0.495,192,506,0.379,528,755,0.699,2194,2010,11
1984,LSU,2012-13,31,19,12,0.613,6300,788,1839,0.428,554,1181,0.469,234,658,0.356,384,614,0.625,2194,2012,13
1985,UCF,2012-13,31,20,11,0.645,6249,768,1695,0.453,548,1079,0.508,220,616,0.357,438,680,0.644,2194,2012,13
1986,Western Ky.,2013-14,32,20,12,0.625,6475,732,1766,0.414,497,1068,0.465,235,698,0.337,495,755,0.656,2194,2013,14
1987,Bowling Green,2014-15,33,21,12,0.636,6626,778,1806,0.431,560,1159,0.483,218,647,0.337,420,588,0.714,2194,2014,15
1988,James Madison,2016-17,33,10,23,0.303,6677,770,1733,0.444,562,1104,0.509,208,629,0.331,446,622,0.717,2194,2016,17
1989,Southern Ill.,2018-19,32,17,15,0.531,6400,802,1720,0.466,589,1150,0.512,213,570,0.374,377,550,0.685,2194,2018,19
1990,Alabama,2015-16,33,18,15,0.545,6650,738,1750,0.422,479,987,0.485,259,763,0.339,458,712,0.643,2193,2015,16
1991,SE Missouri St,2011-12,31,15,16,0.484,6225,819,1724,0.475,638,1234,0.517,181,490,0.369,373,592,0.63,2192,2011,12
1992,Auburn,2015-16,31,11,20,0.355,6225,724,1820,0.398,452,1021,0.443,272,799,0.34,472,746,0.633,2192,2015,16
1993,Denver,2017-18,30,15,15,0.5,6100,803,1699,0.473,592,1172,0.505,211,527,0.4,375,540,0.694,2192,2017,18
1994,Fla. Atlantic,2010-11,32,21,11,0.656,6451,784,1765,0.444,617,1250,0.494,167,515,0.324,456,692,0.659,2191,2010,11
1995,NC State,2010-11,31,15,16,0.484,6198,799,1818,0.439,660,1395,0.473,139,423,0.329,454,654,0.694,2191,2010,11
1996,Arkansas,2010-11,31,18,13,0.581,6300,756,1734,0.436,552,1171,0.471,204,563,0.362,475,683,0.695,2191,2010,11
1997,Charleston,2011-12,31,19,12,0.613,6300,754,1769,0.426,509,1044,0.488,245,725,0.338,438,683,0.641,2191,2011,12
1998,Miami (OH),2010-11,33,16,17,0.485,6775,743,1722,0.431,494,1008,0.49,249,714,0.349,455,625,0.728,2190,2010,11
1999,Texas Tech,2013-14,32,14,18,0.438,6427,783,1718,0.456,643,1268,0.507,140,450,0.311,484,665,0.728,2190,2013,14
2000,Western Caro.,2017-18,32,13,19,0.406,6401,774,1885,0.411,540,1182,0.457,234,703,0.333,408,597,0.683,2190,2017,18
,,,,,,,,School,School,School,School,School,School,School,School,School,School,School,School,School,,
,Schl,Season,G,W,L,W-L%,MP,FG,FGA,FG%,2P,2PA,2P%,3P,3PA,3P%,FT,FTA,FT%,PTS,Season,
2001,Texas State,2017-18,33,15,18,0.455,6650,773,1782,0.434,559,1134,0.493,214,648,0.33,430,651,0.661,2190,2017,18
2002,Louisiana,2011-12,32,16,16,0.5,6525,767,1790,0.428,595,1265,0.47,172,525,0.328,483,766,0.631,2189,2011,12
2003,Tennessee,2012-13,33,20,13,0.606,6700,753,1751,0.43,580,1203,0.482,173,548,0.316,510,739,0.69,2189,2012,13
2004,Washington St.,2014-15,31,13,18,0.419,6275,743,1712,0.434,529,1086,0.487,214,626,0.342,489,679,0.72,2189,2014,15
2005,Fla. Atlantic,2015-16,33,8,25,0.242,6625,752,1847,0.407,523,1169,0.447,229,678,0.338,456,624,0.731,2189,2015,16
2006,Air Force,2015-16,32,14,18,0.438,6501,752,1758,0.428,550,1162,0.473,202,596,0.339,483,707,0.683,2189,2015,16
2007,Arkansas State,2010-11,32,17,15,0.531,6426,745,1724,0.432,578,1218,0.475,167,506,0.33,531,750,0.708,2188,2010,11
2008,North Dakota St.,2010-11,29,14,15,0.483,5875,778,1651,0.471,613,1219,0.503,165,432,0.382,467,674,0.693,2188,2010,11
2009,Norfolk State,2012-13,33,21,12,0.636,6625,769,1850,0.416,597,1321,0.452,172,529,0.325,478,740,0.646,2188,2012,13
2010,CS Long Beach,2014-15,33,16,17,0.485,6649,761,1809,0.421,531,1137,0.467,230,672,0.342,436,638,0.683,2188,2014,15
2011,Tulsa,2014-15,34,23,11,0.676,6850,758,1820,0.416,570,1234,0.462,188,586,0.321,484,746,0.649,2188,2014,15
2012,Little Rock,2016-17,32,15,17,0.469,6450,775,1749,0.443,568,1150,0.494,207,599,0.346,431,582,0.741,2188,2016,17
2013,Washington St.,2015-16,31,9,22,0.29,6300,805,1760,0.457,621,1230,0.505,184,530,0.347,393,551,0.713,2187,2015,16
2014,App. St.,2015-16,31,9,22,0.29,6201,719,1795,0.401,463,1075,0.431,256,720,0.356,493,701,0.703,2187,2015,16
2015,Miss Val St,2010-11,32,13,19,0.406,6449,752,1855,0.405,548,1225,0.447,204,630,0.324,478,719,0.665,2186,2010,11
2016,Central Conn St,2012-13,30,13,17,0.433,6100,785,1832,0.428,573,1230,0.466,212,602,0.352,404,552,0.732,2186,2012,13
2017,Southeastern LA,2014-15,32,9,23,0.281,6475,807,1760,0.459,622,1169,0.532,185,591,0.313,387,582,0.665,2186,2014,15
2018,East Carolina,2015-16,32,12,20,0.375,6525,761,1790,0.425,529,1107,0.478,232,683,0.34,432,620,0.697,2186,2015,16
2019,San Jose State,2015-16,31,9,22,0.29,6225,756,1783,0.424,544,1093,0.498,212,690,0.307,462,701,0.659,2186,2015,16
2020,Delaware State,2016-17,32,10,22,0.313,6475,782,1865,0.419,519,1138,0.456,263,727,0.362,359,545,0.659,2186,2016,17
2021,Boston U.,2017-18,31,15,16,0.484,6201,800,1730,0.462,571,1116,0.512,229,614,0.373,357,559,0.639,2186,2017,18
2022,Northern Colo.,2012-13,31,13,18,0.419,6224,796,1718,0.463,585,1158,0.505,211,560,0.377,381,565,0.674,2184,2012,13
2023,McNeese State,2017-18,29,12,17,0.414,5850,780,1787,0.436,575,1190,0.483,205,597,0.343,419,590,0.71,2184,2017,18
2024,Milwaukee,2011-12,34,20,14,0.588,6825,748,1792,0.417,484,1028,0.471,264,764,0.346,423,691,0.612,2183,2011,12
2025,Fairl. Dickinson,2016-17,30,11,19,0.367,6025,754,1713,0.44,553,1107,0.5,201,606,0.332,474,620,0.765,2183,2016,17
2026,Prairie View,2012-13,34,15,19,0.441,6828,822,2065,0.398,693,1571,0.441,129,494,0.261,409,665,0.615,2182,2012,13
2027,Kennesaw State,2017-18,30,10,20,0.333,6025,805,1771,0.455,645,1333,0.484,160,438,0.365,412,597,0.69,2182,2017,18
2028,Harvard,2017-18,32,18,14,0.563,6524,764,1775,0.43,507,1046,0.485,257,729,0.353,397,512,0.775,2182,2017,18
2029,Tennessee State,2018-19,30,9,21,0.3,6050,751,1739,0.432,511,1023,0.5,240,716,0.335,440,628,0.701,2182,2018,19
2030,Jacksonville,2012-13,32,14,18,0.438,6503,774,1831,0.423,608,1319,0.461,166,512,0.324,467,664,0.703,2181,2012,13
2031,IUPUI,2015-16,32,13,19,0.406,6453,785,1858,0.422,602,1309,0.46,183,549,0.333,428,607,0.705,2181,2015,16
2032,UConn,2017-18,32,14,18,0.438,6500,762,1832,0.416,547,1173,0.466,215,659,0.326,442,593,0.745,2181,2017,18
2033,Stetson,2012-13,31,15,16,0.484,6200,768,1683,0.456,538,1021,0.527,230,662,0.347,414,587,0.705,2180,2012,13
2034,Vanderbilt,2018-19,32,9,23,0.281,6425,736,1750,0.421,506,1011,0.5,230,739,0.311,478,710,0.673,2180,2018,19
2035,UC-Irvine,2011-12,32,12,20,0.375,6450,776,1861,0.417,526,1161,0.453,250,700,0.357,377,592,0.637,2179,2011,12
2036,Texas Southern,2012-13,31,17,14,0.548,6301,776,1763,0.44,499,985,0.507,277,778,0.356,350,550,0.636,2179,2012,13
2037,Tulane,2016-17,31,6,25,0.194,6275,751,1856,0.405,530,1173,0.452,221,683,0.324,456,636,0.717,2179,2016,17
2038,Washington St.,2016-17,31,13,18,0.419,6225,801,1739,0.461,592,1165,0.508,209,574,0.364,368,487,0.756,2179,2016,17
2039,Air Force,2018-19,32,14,18,0.438,6500,802,1776,0.452,568,1065,0.533,234,711,0.329,341,503,0.678,2179,2018,19
2040,Troy,2018-19,30,12,18,0.4,6050,773,1719,0.45,537,1015,0.529,236,704,0.335,397,550,0.722,2179,2018,19
2041,Md.-East. Shore,2015-16,32,10,22,0.313,6475,759,1715,0.443,558,1105,0.505,201,610,0.33,459,648,0.708,2178,2015,16
2042,FIU,2016-17,31,7,24,0.226,6350,805,1773,0.454,624,1228,0.508,181,545,0.332,387,516,0.75,2178,2016,17
2043,UTSA,2016-17,33,14,19,0.424,6600,769,1959,0.393,597,1351,0.442,172,608,0.283,468,703,0.666,2178,2016,17
2044,Oklahoma State,2018-19,32,12,20,0.375,6425,760,1796,0.423,480,1043,0.46,280,753,0.372,378,549,0.689,2178,2018,19
2045,Cleveland State,2011-12,33,22,11,0.667,6600,804,1798,0.447,587,1199,0.49,217,599,0.362,352,496,0.71,2177,2011,12
2046,Colgate,2014-15,33,16,17,0.485,6725,804,1661,0.484,551,1012,0.544,253,649,0.39,316,453,0.698,2177,2014,15
2047,Rider,2015-16,33,13,20,0.394,6700,769,1803,0.427,565,1156,0.489,204,647,0.315,435,638,0.682,2177,2015,16
2048,Jacksonville,2010-11,32,20,12,0.625,6524,779,1846,0.422,635,1383,0.459,144,463,0.311,474,708,0.669,2176,2010,11
2049,Marist,2011-12,32,14,18,0.438,6450,721,1733,0.416,518,1164,0.445,203,569,0.357,531,734,0.723,2176,2011,12
2050,Texas A&M,2016-17,31,16,15,0.516,6200,804,1754,0.458,615,1180,0.521,189,574,0.329,379,584,0.649,2176,2016,17
2051,Coppin State,2010-11,30,16,14,0.533,6100,760,1770,0.429,528,1131,0.467,232,639,0.363,423,603,0.701,2175,2010,11
2052,Florida A&M,2011-12,33,10,23,0.303,6649,820,2019,0.406,637,1450,0.439,183,569,0.322,352,572,0.615,2175,2011,12
2053,Elon,2011-12,31,15,16,0.484,6275,770,1831,0.421,532,1160,0.459,238,671,0.355,397,589,0.674,2175,2011,12
2054,Binghamton,2016-17,32,12,20,0.375,6425,768,1757,0.437,520,1072,0.485,248,685,0.362,391,555,0.705,2175,2016,17
2055,Loyola (MD),2016-17,33,16,17,0.485,6650,753,1791,0.42,576,1253,0.46,177,538,0.329,492,711,0.692,2175,2016,17
2056,UC-Davis,2013-14,31,9,22,0.29,6350,745,1701,0.438,500,1014,0.493,245,687,0.357,439,631,0.696,2174,2013,14
2057,St. John's (NY),2015-16,32,8,24,0.25,6400,757,1864,0.406,551,1231,0.448,206,633,0.325,454,714,0.636,2174,2015,16
2058,Idaho,2018-19,32,5,27,0.156,6421,778,1764,0.441,527,1086,0.485,251,678,0.37,367,507,0.724,2174,2018,19
2059,Ohio,2018-19,31,14,17,0.452,6274,803,1838,0.437,616,1205,0.511,187,633,0.295,381,602,0.633,2174,2018,19
2060,Idaho,2010-11,32,18,14,0.563,6480,758,1644,0.461,556,1116,0.498,202,528,0.383,454,629,0.722,2172,2010,11
2061,Fort Wayne,2014-15,31,16,15,0.516,6200,754,1603,0.47,533,984,0.542,221,619,0.357,442,645,0.685,2171,2014,15
2062,Cal Poly,2015-16,30,10,20,0.333,6100,755,1812,0.417,517,1131,0.457,238,681,0.349,423,626,0.676,2171,2015,16
2063,Central Conn St,2017-18,32,14,18,0.438,6525,788,1740,0.453,590,1139,0.518,198,601,0.329,397,568,0.699,2171,2017,18
2064,Chicago State,2017-18,32,3,29,0.094,6401,774,1898,0.408,605,1349,0.448,169,549,0.308,454,627,0.724,2171,2017,18
2065,UCSB,2010-11,32,18,14,0.563,6475,742,1636,0.454,515,1025,0.502,227,611,0.372,459,610,0.752,2170,2010,11
2066,Central Conn St,2010-11,31,19,12,0.613,6275,766,1758,0.436,614,1294,0.474,152,464,0.328,486,634,0.767,2170,2010,11
2067,Fresno State,2011-12,33,13,20,0.394,6775,745,1820,0.409,551,1203,0.458,194,617,0.314,486,674,0.721,2170,2011,12
2068,Alabama,2013-14,32,13,19,0.406,6475,741,1669,0.444,558,1121,0.498,183,548,0.334,505,737,0.685,2170,2013,14
2069,Indiana State,2015-16,32,15,17,0.469,6475,715,1822,0.392,505,1130,0.447,210,692,0.303,530,765,0.693,2170,2015,16
2070,Indiana State,2016-17,31,11,20,0.355,6375,762,1832,0.416,508,1105,0.46,254,727,0.349,392,576,0.681,2170,2016,17
2071,Saint Louis,2017-18,33,17,16,0.515,6625,731,1734,0.422,546,1161,0.47,185,573,0.323,523,802,0.652,2170,2017,18
2072,Towson,2018-19,32,10,22,0.313,6553,810,1860,0.435,630,1310,0.481,180,550,0.327,370,532,0.695,2170,2018,19
2073,Portland State,2010-11,30,14,16,0.467,6000,745,1697,0.439,534,1097,0.487,211,600,0.352,468,645,0.726,2169,2010,11
2074,Rhode Island,2013-14,32,14,18,0.438,6426,754,1703,0.443,602,1229,0.49,152,474,0.321,509,779,0.653,2169,2013,14
2075,N.C. A&T,2015-16,32,10,22,0.313,6527,745,1836,0.406,546,1203,0.454,199,633,0.314,480,675,0.711,2169,2015,16
2076,Eastern Ill.,2016-17,29,14,15,0.483,5975,772,1852,0.417,513,1156,0.444,259,696,0.372,366,501,0.731,2169,2016,17
2077,Bryant,2017-18,31,3,28,0.097,6225,771,1881,0.41,512,1126,0.455,259,755,0.343,368,522,0.705,2169,2017,18
2078,USC Upstate,2018-19,32,6,26,0.188,6450,775,1872,0.414,506,1055,0.48,269,817,0.329,350,492,0.711,2169,2018,19
2079,North Florida,2011-12,32,16,16,0.5,6500,787,1720,0.458,586,1159,0.506,201,561,0.358,393,645,0.609,2168,2011,12
2080,Sam Houston St.,2012-13,34,17,17,0.5,6900,740,1918,0.386,516,1240,0.416,224,678,0.33,464,707,0.656,2168,2012,13
2081,Canisius,2014-15,33,18,15,0.545,6650,762,1864,0.409,547,1187,0.461,215,677,0.318,429,596,0.72,2168,2014,15
2082,Nebraska,2016-17,31,12,19,0.387,6300,793,1906,0.416,614,1346,0.456,179,560,0.32,403,568,0.71,2168,2016,17
2083,Northern Iowa,2010-11,34,20,14,0.588,6800,728,1702,0.428,478,975,0.49,250,727,0.344,461,605,0.762,2167,2010,11
2084,SC St.,2016-17,31,11,20,0.355,6250,796,1849,0.431,611,1271,0.481,185,578,0.32,390,564,0.691,2167,2016,17
2085,UCF,2011-12,33,22,11,0.667,6600,768,1777,0.432,590,1185,0.498,178,592,0.301,452,722,0.626,2166,2011,12
2086,Rider,2012-13,34,19,15,0.559,6809,748,1733,0.432,541,1133,0.477,207,600,0.345,463,683,0.678,2166,2012,13
2087,Rutgers,2015-16,32,7,25,0.219,6475,785,1878,0.418,624,1375,0.454,161,503,0.32,435,640,0.68,2166,2015,16
2088,Siena,2017-18,32,8,24,0.25,6625,752,1790,0.42,532,1190,0.447,220,600,0.367,442,652,0.678,2166,2017,18
2089,California,2017-18,32,8,24,0.25,6425,767,1887,0.406,619,1369,0.452,148,518,0.286,484,717,0.675,2166,2017,18
2090,Liberty,2010-11,32,19,13,0.594,6500,779,1827,0.426,613,1311,0.468,166,516,0.322,441,643,0.686,2165,2010,11
2091,Miss. St.,2010-11,31,17,14,0.548,6225,739,1701,0.434,493,1021,0.483,246,680,0.362,441,610,0.723,2165,2010,11
2092,Central Ark.,2013-14,29,8,21,0.276,5842,787,1761,0.447,596,1239,0.481,191,522,0.366,400,666,0.601,2165,2013,14
2093,Howard,2016-17,34,10,24,0.294,6800,723,1856,0.39,551,1265,0.436,172,591,0.291,547,833,0.657,2165,2016,17
2094,Ball State,2010-11,32,19,13,0.594,6475,724,1623,0.446,575,1180,0.487,149,443,0.336,567,818,0.693,2164,2010,11
2095,Campbell,2013-14,32,12,20,0.375,6474,771,1747,0.441,493,952,0.518,278,795,0.35,344,508,0.677,2164,2013,14
2096,Tulane,2013-14,34,17,17,0.5,6824,694,1681,0.413,489,1097,0.446,205,584,0.351,571,823,0.694,2164,2013,14
2097,Army,2014-15,30,15,15,0.5,6075,779,1768,0.441,552,1071,0.515,227,697,0.326,379,557,0.68,2164,2014,15
2098,Siena,2014-15,31,11,20,0.355,6224,748,1736,0.431,596,1278,0.466,152,458,0.332,516,727,0.71,2164,2014,15
2099,UMKC,2014-15,33,14,19,0.424,6726,723,1776,0.407,507,1127,0.45,216,649,0.333,502,724,0.693,2164,2014,15
2100,Yale,2014-15,32,22,10,0.688,6500,740,1667,0.444,520,1072,0.485,220,595,0.37,464,653,0.711,2164,2014,15
,,,,,,,,School,School,School,School,School,School,School,School,School,School,School,School,School,,
,Schl,Season,G,W,L,W-L%,MP,FG,FGA,FG%,2P,2PA,2P%,3P,3PA,3P%,FT,FTA,FT%,PTS,Season,
2101,Idaho State,2016-17,31,5,26,0.161,6250,742,1708,0.434,505,1048,0.482,237,660,0.359,443,648,0.684,2164,2016,17
2102,Grand Canyon,2013-14,30,15,15,0.5,6025,671,1549,0.433,465,961,0.484,206,588,0.35,615,831,0.74,2163,2013,14
2103,Bradley,2016-17,33,13,20,0.394,6625,731,1722,0.425,514,1113,0.462,217,609,0.356,484,719,0.673,2163,2016,17
2104,Rutgers,2016-17,33,15,18,0.455,6626,809,1967,0.411,657,1465,0.448,152,502,0.303,393,631,0.623,2163,2016,17
2105,Morgan State,2012-13,32,17,15,0.531,6500,806,1807,0.446,673,1351,0.498,133,456,0.292,417,708,0.589,2162,2012,13
2106,Sacred Heart,2013-14,31,5,26,0.161,6275,758,1836,0.413,561,1233,0.455,197,603,0.327,449,655,0.685,2162,2013,14
2107,Hartford,2013-14,33,17,16,0.515,6624,731,1593,0.459,466,889,0.524,265,704,0.376,435,619,0.703,2162,2013,14
2108,Stanford,2016-17,31,14,17,0.452,6225,772,1753,0.44,615,1263,0.487,157,490,0.32,461,676,0.682,2162,2016,17
2109,Sam Houston St.,2010-11,31,18,13,0.581,6225,769,1747,0.44,584,1123,0.52,185,624,0.296,438,663,0.661,2161,2010,11
2110,Lafayette,2011-12,31,13,18,0.419,6200,723,1650,0.438,440,915,0.481,283,735,0.385,432,566,0.763,2161,2011,12
2111,San Francisco,2012-13,31,15,16,0.484,6225,756,1669,0.453,507,1048,0.484,249,621,0.401,400,600,0.667,2161,2012,13
2112,Utah Valley,2013-14,32,20,12,0.625,6425,731,1676,0.436,523,1076,0.486,208,600,0.347,491,650,0.755,2161,2013,14
2113,Morgan State,2018-19,30,9,21,0.3,6042,758,1920,0.395,590,1399,0.422,168,521,0.322,477,669,0.713,2161,2018,19
2114,American,2018-19,30,15,15,0.5,6101,780,1645,0.474,590,1061,0.556,190,584,0.325,411,589,0.698,2161,2018,19
2115,Oklahoma State,2014-15,32,18,14,0.563,6450,733,1667,0.44,507,1020,0.497,226,647,0.349,468,645,0.726,2160,2014,15
2116,Dartmouth,2018-19,30,11,19,0.367,6051,791,1750,0.452,527,1029,0.512,264,721,0.366,314,436,0.72,2160,2018,19
2117,Indiana State,2012-13,33,18,15,0.545,6700,733,1709,0.429,547,1130,0.484,186,579,0.321,507,717,0.707,2159,2012,13
2118,Clemson,2015-16,31,17,14,0.548,6250,753,1725,0.437,515,1047,0.492,238,678,0.351,415,574,0.723,2159,2015,16
2119,Colgate,2013-14,31,13,18,0.419,6300,785,1622,0.484,525,965,0.544,260,657,0.396,328,459,0.715,2158,2013,14
2120,Tulsa,2016-17,32,15,17,0.469,6425,701,1673,0.419,467,990,0.472,234,683,0.343,522,716,0.729,2158,2016,17
2121,LSU,2011-12,33,18,15,0.545,6700,791,1947,0.406,618,1417,0.436,173,530,0.326,402,582,0.691,2157,2011,12
2122,Utah Valley,2012-13,32,14,18,0.438,6550,793,1749,0.453,612,1207,0.507,181,542,0.334,390,549,0.71,2157,2012,13
2123,Fairl. Dickinson,2013-14,31,10,21,0.323,6250,742,1766,0.42,516,1130,0.457,226,636,0.355,447,621,0.72,2157,2013,14
2124,Delaware,2016-17,33,13,20,0.394,6625,775,1838,0.422,579,1195,0.485,196,643,0.305,411,599,0.686,2157,2016,17
2125,Sacramento St.,2017-18,32,7,25,0.219,6425,800,1802,0.444,598,1232,0.485,202,570,0.354,355,519,0.684,2157,2017,18
2126,St. Bonaventure,2010-11,31,16,15,0.516,6450,744,1632,0.456,575,1151,0.5,169,481,0.351,499,714,0.699,2156,2010,11
2127,Virginia Tech,2014-15,33,11,22,0.333,6650,779,1747,0.446,538,1128,0.477,241,619,0.389,357,558,0.64,2156,2014,15
2128,Albany (NY),2014-15,33,24,9,0.727,6624,729,1666,0.438,524,1094,0.479,205,572,0.358,493,650,0.758,2156,2014,15
2129,Memphis,2014-15,32,18,14,0.563,6450,802,1827,0.439,636,1321,0.481,166,506,0.328,385,578,0.666,2155,2014,15
2130,St. Joseph's,2016-17,31,11,20,0.355,6250,755,1808,0.418,581,1271,0.457,174,537,0.324,471,725,0.65,2155,2016,17
2131,Fla. Atlantic,2017-18,31,12,19,0.387,6224,790,1929,0.41,611,1378,0.443,179,551,0.325,396,536,0.739,2155,2017,18
2132,Baylor,2010-11,31,18,13,0.581,6225,752,1618,0.465,588,1144,0.514,164,474,0.346,486,699,0.695,2154,2010,11
2133,Green Bay,2010-11,32,14,18,0.438,6449,787,1801,0.437,635,1324,0.48,152,477,0.319,428,621,0.689,2154,2010,11
2134,George Mason,2013-14,31,11,20,0.355,6275,756,1719,0.44,603,1284,0.47,153,435,0.352,489,690,0.709,2154,2013,14
2135,McNeese State,2014-15,31,15,16,0.484,6250,792,1873,0.423,599,1253,0.478,193,620,0.311,377,579,0.651,2154,2014,15
2136,Loyola (MD),2017-18,31,9,22,0.29,6275,797,1820,0.438,634,1311,0.484,163,509,0.32,397,608,0.653,2154,2017,18
2137,Loyola (IL),2010-11,31,16,15,0.516,6225,741,1733,0.428,541,1180,0.458,200,553,0.362,471,639,0.737,2153,2010,11
2138,Robert Morris,2010-11,32,18,14,0.563,6475,752,1792,0.42,537,1189,0.452,215,603,0.357,434,634,0.685,2153,2010,11
2139,North Dakota,2011-12,32,17,15,0.531,6425,762,1722,0.443,561,1113,0.504,201,609,0.33,428,679,0.63,2153,2011,12
2140,Rider,2014-15,33,21,12,0.636,6675,784,1790,0.438,584,1191,0.49,200,599,0.334,385,638,0.603,2153,2014,15
2141,Missouri State,2015-16,32,13,19,0.406,6449,752,1817,0.414,584,1284,0.455,168,533,0.315,481,713,0.675,2153,2015,16
2142,Florida A&M,2016-17,30,7,23,0.233,6100,762,1800,0.423,575,1262,0.456,187,538,0.348,442,671,0.659,2153,2016,17
2143,UC-Riverside,2018-19,33,10,23,0.303,6626,792,1787,0.443,513,1044,0.491,279,743,0.376,290,424,0.684,2153,2018,19
2144,Houston,2011-12,30,15,15,0.5,6075,795,1714,0.464,631,1250,0.505,164,464,0.353,398,565,0.704,2152,2011,12
2145,UMKC,2015-16,31,12,19,0.387,6225,746,1738,0.429,533,1150,0.463,213,588,0.362,447,663,0.674,2152,2015,16
2146,Binghamton,2018-19,33,10,23,0.303,6600,793,1842,0.431,518,1054,0.491,275,788,0.349,291,452,0.644,2152,2018,19
2147,Wake Forest,2010-11,32,8,24,0.25,6400,735,1736,0.423,551,1223,0.451,184,513,0.359,497,666,0.746,2151,2010,11
2148,Montana,2010-11,32,21,11,0.656,6450,766,1657,0.462,618,1183,0.522,148,474,0.312,471,705,0.668,2151,2010,11
2149,Chicago State,2012-13,33,11,22,0.333,6725,779,1949,0.4,548,1257,0.436,231,692,0.334,362,498,0.727,2151,2012,13
2150,Wyoming,2014-15,35,25,10,0.714,7152,747,1619,0.461,538,977,0.551,209,642,0.326,448,638,0.702,2151,2014,15
2151,Yale,2016-17,29,18,11,0.621,5825,769,1644,0.468,561,1062,0.528,208,582,0.357,405,553,0.732,2151,2016,17
2152,Stetson,2018-19,31,7,24,0.226,6225,794,1962,0.405,579,1278,0.453,215,684,0.314,348,503,0.692,2151,2018,19
2153,FIU,2010-11,30,11,19,0.367,6100,718,1638,0.438,554,1138,0.487,164,500,0.328,550,802,0.686,2150,2010,11
2154,Fairfield,2010-11,33,25,8,0.758,6625,777,1795,0.433,638,1332,0.479,139,463,0.3,457,699,0.654,2150,2010,11
2155,St. Joseph's,2012-13,32,18,14,0.563,6450,746,1702,0.438,517,1033,0.5,229,669,0.342,429,616,0.696,2150,2012,13
2156,Missouri,2018-19,32,15,17,0.469,6450,758,1764,0.43,494,1037,0.476,264,727,0.363,370,526,0.703,2150,2018,19
2157,Albany (NY),2018-19,32,12,20,0.375,6500,728,1750,0.416,454,960,0.473,274,790,0.347,420,564,0.745,2150,2018,19
2158,Illinois State,2015-16,32,18,14,0.563,6425,759,1835,0.414,521,1129,0.461,238,706,0.337,393,588,0.668,2149,2015,16
2159,Hampton,2016-17,31,14,17,0.452,6249,751,1844,0.407,555,1224,0.453,196,620,0.316,451,633,0.712,2149,2016,17
2160,Princeton,2016-17,30,23,7,0.767,6025,772,1716,0.45,474,927,0.511,298,789,0.378,307,416,0.738,2149,2016,17
2161,Cornell,2018-19,31,15,16,0.484,6300,754,1705,0.442,511,974,0.525,243,731,0.332,398,551,0.722,2149,2018,19
2162,McNeese State,2018-19,31,9,22,0.29,6225,760,1676,0.453,592,1128,0.525,168,548,0.307,461,647,0.713,2149,2018,19
2163,Rice,2010-11,32,14,18,0.438,6475,725,1696,0.427,557,1183,0.471,168,513,0.327,530,733,0.723,2148,2010,11
2164,New Hampshire,2014-15,32,19,13,0.594,6525,747,1712,0.436,516,1095,0.471,231,617,0.374,423,627,0.675,2148,2014,15
2165,Cal St Northridge,2014-15,33,9,24,0.273,6650,740,1742,0.425,630,1405,0.448,110,337,0.326,558,729,0.765,2148,2014,15
2166,Vermont,2010-11,32,23,9,0.719,6450,779,1741,0.447,628,1311,0.479,151,430,0.351,438,648,0.676,2147,2010,11
2167,Oregon State,2010-11,31,11,20,0.355,6200,737,1727,0.427,577,1200,0.481,160,527,0.304,513,753,0.681,2147,2010,11
2168,Virginia Tech,2011-12,33,16,17,0.485,6650,754,1797,0.42,549,1235,0.445,205,562,0.365,434,599,0.725,2147,2011,12
2169,Binghamton,2017-18,31,11,20,0.355,6225,787,1775,0.443,552,1104,0.5,235,671,0.35,338,528,0.64,2147,2017,18
2170,Manhattan,2017-18,31,14,17,0.452,6300,737,1661,0.444,498,1063,0.468,239,598,0.4,434,625,0.694,2147,2017,18
2171,Alabama State,2010-11,35,17,18,0.486,7050,728,1841,0.395,563,1258,0.448,165,583,0.283,525,870,0.603,2146,2010,11
2172,Penn,2011-12,33,20,13,0.606,6675,767,1731,0.443,529,1094,0.484,238,637,0.374,374,513,0.729,2146,2011,12
2173,Eastern Wash.,2012-13,31,10,21,0.323,6299,751,1811,0.415,487,1036,0.47,264,775,0.341,380,580,0.655,2146,2012,13
2174,South Carolina,2014-15,33,17,16,0.515,6600,735,1819,0.404,555,1220,0.455,180,599,0.301,496,673,0.737,2146,2014,15
2175,Lamar,2014-15,30,15,15,0.5,6025,750,1658,0.452,581,1126,0.516,169,532,0.318,477,701,0.68,2146,2014,15
2176,Little Rock,2014-15,31,13,18,0.419,6375,741,1779,0.417,522,1143,0.457,219,636,0.344,445,632,0.704,2146,2014,15
2177,Charleston So.,2015-16,30,9,21,0.3,6050,774,1808,0.428,494,998,0.495,280,810,0.346,318,512,0.621,2146,2015,16
2178,Indiana State,2018-19,31,15,16,0.484,6245,757,1719,0.44,579,1228,0.471,178,491,0.363,454,621,0.731,2146,2018,19
2179,Milwaukee,2018-19,31,9,22,0.29,6220,765,1820,0.42,528,1128,0.468,237,692,0.342,379,508,0.746,2146,2018,19
2180,Incarnate Word,2015-16,29,17,12,0.586,5825,718,1653,0.434,484,1031,0.469,234,622,0.376,475,620,0.766,2145,2015,16
2181,Eastern Ill.,2015-16,30,13,17,0.433,6100,764,1737,0.44,532,1073,0.496,232,664,0.349,385,587,0.656,2145,2015,16
2182,Marist,2015-16,30,7,23,0.233,6099,723,1713,0.422,475,987,0.481,248,726,0.342,451,615,0.733,2145,2015,16
2183,Troy,2015-16,31,9,22,0.29,6250,740,1817,0.407,532,1142,0.466,208,675,0.308,457,713,0.641,2145,2015,16
2184,Colgate,2016-17,32,10,22,0.313,6525,745,1693,0.44,474,961,0.493,271,732,0.37,384,567,0.677,2145,2016,17
2185,North Alabama,2018-19,32,10,22,0.313,6422,744,1914,0.389,504,1109,0.454,240,805,0.298,417,619,0.674,2145,2018,19
2186,Penn State,2010-11,34,19,15,0.559,6800,767,1748,0.439,551,1110,0.496,216,638,0.339,394,544,0.724,2144,2010,11
2187,Harvard,2010-11,30,23,7,0.767,6051,708,1492,0.475,503,949,0.53,205,543,0.378,523,646,0.81,2144,2010,11
2188,Auburn,2013-14,30,14,16,0.467,6006,723,1656,0.437,551,1102,0.5,172,554,0.31,526,730,0.721,2144,2013,14
2189,Northern Ariz.,2013-14,32,15,17,0.469,6449,778,1715,0.454,608,1230,0.494,170,485,0.351,418,586,0.713,2144,2013,14
2190,Jacksonville St.,2011-12,33,15,18,0.455,6650,748,1761,0.425,604,1228,0.492,144,533,0.27,503,742,0.678,2143,2011,12
2191,USC,2014-15,32,12,20,0.375,6500,787,1863,0.422,617,1346,0.458,170,517,0.329,399,629,0.634,2143,2014,15
2192,Cal St Northridge,2015-16,30,10,20,0.333,6130,745,1723,0.432,619,1298,0.477,126,425,0.296,527,735,0.717,2143,2015,16
2193,Oklahoma,2011-12,31,15,16,0.484,6225,794,1827,0.435,653,1426,0.458,141,401,0.352,413,568,0.727,2142,2011,12
2194,Lafayette,2015-16,30,6,24,0.2,6176,758,1742,0.435,513,1071,0.479,245,671,0.365,381,551,0.691,2142,2015,16
2195,Princeton,2011-12,32,20,12,0.625,6499,776,1681,0.462,540,1053,0.513,236,628,0.376,353,520,0.679,2141,2011,12
2196,Cal Poly,2013-14,34,14,20,0.412,6800,754,1850,0.408,536,1196,0.448,218,654,0.333,415,603,0.688,2141,2013,14
2197,Saint Mary's,2014-15,31,21,10,0.677,6300,752,1645,0.457,527,1042,0.506,225,603,0.373,412,576,0.715,2141,2014,15
2198,North Dakota St.,2014-15,33,23,10,0.697,6675,743,1713,0.434,513,1113,0.461,230,600,0.383,425,614,0.692,2141,2014,15
2199,Middle Tenn.,2018-19,32,11,21,0.344,6400,778,1858,0.419,566,1208,0.469,212,650,0.326,373,551,0.677,2141,2018,19
2200,Houston Baptist,2010-11,31,5,26,0.161,6250,735,1818,0.404,555,1281,0.433,180,537,0.335,490,725,0.676,2140,2010,11
,,,,,,,,School,School,School,School,School,School,School,School,School,School,School,School,School,,
,Schl,Season,G,W,L,W-L%,MP,FG,FGA,FG%,2P,2PA,2P%,3P,3PA,3P%,FT,FTA,FT%,PTS,Season,
2201,Monmouth,2011-12,32,12,20,0.375,6450,777,1855,0.419,583,1272,0.458,194,583,0.333,392,603,0.65,2140,2011,12
2202,Northern Ariz.,2012-13,32,11,21,0.344,6526,788,1805,0.437,607,1251,0.485,181,554,0.327,383,567,0.675,2140,2012,13
2203,Chicago State,2015-16,32,4,28,0.125,6400,764,1995,0.383,536,1245,0.431,228,750,0.304,384,573,0.67,2140,2015,16
2204,George Mason,2015-16,32,11,21,0.344,6450,766,1888,0.406,594,1299,0.457,172,589,0.292,436,650,0.671,2140,2015,16
2205,Pepperdine,2016-17,31,9,22,0.29,6199,807,1811,0.446,629,1329,0.473,178,482,0.369,348,543,0.641,2140,2016,17
2206,Maine,2017-18,32,6,26,0.188,6475,765,1873,0.408,540,1128,0.479,225,745,0.302,385,559,0.689,2140,2017,18
2207,Seattle,2013-14,30,13,17,0.433,6075,760,1798,0.423,538,1141,0.472,222,657,0.338,397,609,0.652,2139,2013,14
2208,Seattle,2010-11,31,11,20,0.355,6201,758,1897,0.4,583,1319,0.442,175,578,0.303,447,680,0.657,2138,2010,11
2209,St. John's (NY),2012-13,33,17,16,0.515,6675,825,1989,0.415,705,1546,0.456,120,443,0.271,368,575,0.64,2138,2012,13
2210,Pacific,2018-19,32,14,18,0.438,6450,710,1681,0.422,512,1115,0.459,198,566,0.35,520,698,0.745,2138,2018,19
2211,Minnesota,2010-11,31,17,14,0.548,6200,753,1660,0.454,601,1186,0.507,152,474,0.321,479,726,0.66,2137,2010,11
2212,UCSB,2013-14,30,21,9,0.7,6075,731,1574,0.464,521,1028,0.507,210,546,0.385,465,657,0.708,2137,2013,14
2213,Nebraska,2013-14,32,19,13,0.594,6400,719,1684,0.427,531,1120,0.474,188,564,0.333,511,713,0.717,2137,2013,14
2214,Marshall,2014-15,32,11,21,0.344,6425,738,1840,0.401,489,1052,0.465,249,788,0.316,412,636,0.648,2137,2014,15
2215,UC-Davis,2010-11,30,10,20,0.333,6135,744,1619,0.46,503,982,0.512,241,637,0.378,407,559,0.728,2136,2010,11
2216,East Carolina,2011-12,31,15,16,0.484,6251,747,1714,0.436,511,1038,0.492,236,676,0.349,406,593,0.685,2136,2011,12
2217,Cal Poly,2011-12,33,18,15,0.545,6600,772,1800,0.429,546,1158,0.472,226,642,0.352,366,524,0.698,2136,2011,12
2218,Seton Hall,2012-13,33,15,18,0.455,6650,744,1704,0.437,483,993,0.486,261,711,0.367,387,588,0.658,2136,2012,13
2219,Radford,2012-13,32,13,19,0.406,6500,750,1888,0.397,556,1271,0.437,194,617,0.314,442,682,0.648,2136,2012,13
2220,UIC,2012-13,34,18,16,0.529,6875,720,1797,0.401,498,1141,0.436,222,656,0.338,474,630,0.752,2136,2012,13
2221,Wagner,2012-13,31,19,12,0.613,6350,756,1731,0.437,624,1315,0.475,132,416,0.317,492,698,0.705,2136,2012,13
2222,South Alabama,2013-14,31,11,20,0.355,6300,716,1776,0.403,475,1052,0.452,241,724,0.333,463,679,0.682,2136,2013,14
2223,Hartford,2016-17,32,9,23,0.281,6475,730,1814,0.402,467,1037,0.45,263,777,0.338,413,591,0.699,2136,2016,17
2224,Alabama,2011-12,33,21,12,0.636,6650,778,1722,0.452,642,1252,0.513,136,470,0.289,443,623,0.711,2135,2011,12
2225,UT-Martin,2017-18,31,10,21,0.323,6275,808,1806,0.447,598,1156,0.517,210,650,0.323,309,426,0.725,2135,2017,18
2226,Hampton,2011-12,33,12,21,0.364,6650,746,1853,0.403,563,1214,0.464,183,639,0.286,459,717,0.64,2134,2011,12
2227,South Florida,2011-12,36,22,14,0.611,7250,772,1765,0.437,603,1231,0.49,169,534,0.316,421,597,0.705,2134,2011,12
2228,Utah State,2012-13,31,21,10,0.677,6275,750,1598,0.469,572,1098,0.521,178,500,0.356,456,631,0.723,2134,2012,13
2229,Monmouth,2014-15,33,18,15,0.545,6675,730,1702,0.429,559,1196,0.467,171,506,0.338,503,697,0.722,2134,2014,15
2230,Tennessee State,2016-17,30,17,13,0.567,6101,744,1680,0.443,574,1178,0.487,170,502,0.339,476,688,0.692,2134,2016,17
2231,Manhattan,2015-16,31,13,18,0.419,6294,708,1644,0.431,476,1001,0.476,232,643,0.361,485,655,0.74,2133,2015,16
2232,High Point,2016-17,31,15,16,0.484,6300,732,1693,0.432,536,1173,0.457,196,520,0.377,473,636,0.744,2133,2016,17
2233,Buffalo,2013-14,29,19,10,0.655,5825,729,1631,0.447,542,1073,0.505,187,558,0.335,487,684,0.712,2132,2013,14
2234,Siena,2018-19,33,17,16,0.515,6725,772,1779,0.434,484,930,0.52,288,849,0.339,299,440,0.68,2131,2018,19
2235,Wyoming,2013-14,33,18,15,0.545,6699,724,1533,0.472,535,995,0.538,189,538,0.351,493,689,0.716,2130,2013,14
2236,St. Joseph's,2010-11,33,11,22,0.333,6650,745,1795,0.415,538,1163,0.463,207,632,0.328,432,611,0.707,2129,2010,11
2237,St. John's (NY),2011-12,32,13,19,0.406,6425,757,1803,0.42,627,1342,0.467,130,461,0.282,485,713,0.68,2129,2011,12
2238,Alabama State,2017-18,31,8,23,0.258,6225,751,1839,0.408,542,1201,0.451,209,638,0.328,418,647,0.646,2129,2017,18
2239,Sacred Heart,2017-18,31,10,21,0.323,6227,796,1823,0.437,617,1224,0.504,179,599,0.299,358,540,0.663,2129,2017,18
2240,Chicago State,2010-11,32,6,26,0.188,6475,759,1893,0.401,614,1402,0.438,145,491,0.295,465,718,0.648,2128,2010,11
2241,FIU,2013-14,31,15,16,0.484,6249,754,1681,0.449,602,1200,0.502,152,481,0.316,468,698,0.67,2128,2013,14
2242,Washington,2014-15,31,16,15,0.516,6226,765,1747,0.438,572,1168,0.49,193,579,0.333,405,593,0.683,2128,2014,15
2243,Oklahoma State,2015-16,32,12,20,0.375,6475,723,1709,0.423,518,1084,0.478,205,625,0.328,477,654,0.729,2128,2015,16
2244,Little Rock,2012-13,32,17,15,0.531,6399,732,1736,0.422,570,1255,0.454,162,481,0.337,501,741,0.676,2127,2012,13
2245,Arkansas State,2012-13,31,19,12,0.613,6375,705,1737,0.406,508,1104,0.46,197,633,0.311,520,762,0.682,2127,2012,13
2246,Rhode Island,2011-12,31,7,24,0.226,6349,757,1888,0.401,592,1295,0.457,165,593,0.278,447,648,0.69,2126,2011,12
2247,IUPUI,2013-14,32,6,26,0.188,6415,782,1784,0.438,642,1334,0.481,140,450,0.311,422,569,0.742,2126,2013,14
2248,Missouri,2015-16,31,10,21,0.323,6196,732,1736,0.422,557,1171,0.476,175,565,0.31,487,688,0.708,2126,2015,16
2249,High Point,2017-18,30,14,16,0.467,6025,775,1691,0.458,612,1235,0.496,163,456,0.357,413,588,0.702,2126,2017,18
2250,Tx AM-CC,2018-19,32,14,18,0.438,6449,774,1803,0.429,572,1182,0.484,202,621,0.325,376,541,0.695,2126,2018,19
2251,Bowling Green,2011-12,32,16,16,0.5,6424,823,1795,0.458,667,1334,0.5,156,461,0.338,323,474,0.681,2125,2011,12
2252,Stony Brook,2011-12,32,22,10,0.688,6425,768,1800,0.427,569,1196,0.476,199,604,0.329,390,563,0.693,2125,2011,12
2253,Towson,2012-13,31,18,13,0.581,6350,754,1717,0.439,586,1192,0.492,168,525,0.32,449,687,0.654,2125,2012,13
2254,Butler,2013-14,31,14,17,0.452,6377,755,1758,0.429,572,1191,0.48,183,567,0.323,432,654,0.661,2125,2013,14
2255,Robert Morris,2016-17,33,14,19,0.424,6625,728,1818,0.4,545,1244,0.438,183,574,0.319,486,750,0.648,2125,2016,17
2256,Nebraska,2010-11,32,19,13,0.594,6435,773,1677,0.461,609,1155,0.527,164,522,0.314,414,590,0.702,2124,2010,11
2257,Cornell,2017-18,28,12,16,0.429,5751,744,1613,0.461,527,974,0.541,217,639,0.34,419,574,0.73,2124,2017,18
2258,Presbyterian,2017-18,32,11,21,0.344,6426,749,1760,0.426,473,988,0.479,276,772,0.358,350,510,0.686,2124,2017,18
2259,Air Force,2017-18,31,12,19,0.387,6225,733,1751,0.419,483,996,0.485,250,755,0.331,408,556,0.734,2124,2017,18
2260,Wright State,2010-11,33,19,14,0.576,6600,710,1648,0.431,493,1041,0.474,217,607,0.357,486,649,0.749,2123,2010,11
2261,Eastern Ky.,2011-12,32,16,16,0.5,6500,744,1715,0.434,513,1034,0.496,231,681,0.339,404,551,0.733,2123,2011,12
2262,Montana,2013-14,30,17,13,0.567,6123,703,1475,0.477,481,882,0.545,222,593,0.374,495,670,0.739,2123,2013,14
2263,Seattle,2014-15,34,18,16,0.529,6825,740,1674,0.442,504,1065,0.473,236,609,0.388,407,612,0.665,2123,2014,15
2264,Rutgers,2010-11,32,15,17,0.469,6475,783,1778,0.44,608,1269,0.479,175,509,0.344,381,563,0.677,2122,2010,11
2265,Evansville,2010-11,32,16,16,0.5,6425,723,1606,0.45,576,1194,0.482,147,412,0.357,529,746,0.709,2122,2010,11
2266,Fairfield,2012-13,35,19,16,0.543,7051,779,1843,0.423,580,1214,0.478,199,629,0.316,365,533,0.685,2122,2012,13
2267,App. St.,2011-12,31,13,18,0.419,6225,746,1693,0.441,543,1102,0.493,203,591,0.343,426,656,0.649,2121,2011,12
2268,Cal St Bakersfield,2011-12,31,16,15,0.516,6225,761,1676,0.454,563,1134,0.496,198,542,0.365,401,587,0.683,2121,2011,12
2269,Texas-Arlington,2012-13,33,19,14,0.576,6600,750,1820,0.412,561,1267,0.443,189,553,0.342,432,663,0.652,2121,2012,13
2270,Lehigh,2013-14,32,14,18,0.438,6503,758,1756,0.432,559,1201,0.465,199,555,0.359,406,574,0.707,2121,2013,14
2271,Troy,2013-14,31,11,20,0.355,6295,703,1688,0.416,484,1043,0.464,219,645,0.34,496,750,0.661,2121,2013,14
2272,Miami (OH),2014-15,32,13,19,0.406,6500,739,1679,0.44,552,1133,0.487,187,546,0.342,456,643,0.709,2121,2014,15
2273,California,2018-19,31,8,23,0.258,6224,739,1735,0.426,532,1143,0.465,207,592,0.35,436,603,0.723,2121,2018,19
2274,Indiana State,2011-12,33,18,15,0.545,6675,722,1719,0.42,521,1131,0.461,201,588,0.342,475,659,0.721,2120,2011,12
2275,Fla. Atlantic,2013-14,32,10,22,0.313,6399,747,1760,0.424,537,1131,0.475,210,629,0.334,416,647,0.643,2120,2013,14
2276,UTSA,2014-15,30,14,16,0.467,6026,717,1701,0.422,526,1114,0.472,191,587,0.325,495,708,0.699,2120,2014,15
2277,UAB,2010-11,31,22,9,0.71,6350,756,1725,0.438,517,1027,0.503,239,698,0.342,368,513,0.717,2119,2010,11
2278,SC St.,2010-11,32,10,22,0.313,6451,764,1781,0.429,586,1222,0.48,178,559,0.318,413,612,0.675,2119,2010,11
2279,North Florida,2012-13,32,13,19,0.406,6400,763,1746,0.437,513,1020,0.503,250,726,0.344,343,519,0.661,2119,2012,13
2280,Marist,2013-14,31,12,19,0.387,6300,709,1736,0.408,508,1156,0.439,201,580,0.347,500,700,0.714,2119,2013,14
2281,Seton Hall,2014-15,31,16,15,0.516,6250,735,1745,0.421,522,1136,0.46,213,609,0.35,436,664,0.657,2119,2014,15
2282,Southern Utah,2015-16,30,6,24,0.2,6050,739,1682,0.439,529,1105,0.479,210,577,0.364,431,607,0.71,2119,2015,16
2283,Coppin State,2016-17,32,8,24,0.25,6450,705,1846,0.382,480,1138,0.422,225,708,0.318,484,745,0.65,2119,2016,17
2284,Wake Forest,2018-19,31,11,20,0.355,6251,714,1812,0.394,517,1172,0.441,197,640,0.308,494,681,0.725,2119,2018,19
2285,Montana State,2012-13,30,13,17,0.433,6100,733,1717,0.427,531,1118,0.475,202,599,0.337,450,626,0.719,2118,2012,13
2286,Princeton,2013-14,30,21,9,0.7,6099,704,1592,0.442,426,818,0.521,278,774,0.359,432,599,0.721,2118,2013,14
2287,Tennessee Tech,2014-15,30,12,18,0.4,6025,768,1741,0.441,599,1215,0.493,169,526,0.321,413,609,0.678,2118,2014,15
2288,Coppin State,2018-19,33,8,25,0.242,6645,710,1827,0.389,470,986,0.477,240,841,0.285,458,689,0.665,2118,2018,19
2289,South Dakota,2018-19,30,13,17,0.433,6025,729,1664,0.438,502,998,0.503,227,666,0.341,433,585,0.74,2118,2018,19
2290,SE Missouri St,2010-11,32,10,22,0.313,6450,731,1678,0.436,568,1200,0.473,163,478,0.341,492,794,0.62,2117,2010,11
2291,North Texas,2012-13,32,12,20,0.375,6475,740,1793,0.413,627,1396,0.449,113,397,0.285,524,740,0.708,2117,2012,13
2292,Utah,2012-13,33,15,18,0.455,6650,754,1717,0.439,558,1175,0.475,196,542,0.362,413,547,0.755,2117,2012,13
2293,UC-Riverside,2013-14,31,10,21,0.323,6301,740,1710,0.433,602,1253,0.48,138,457,0.302,499,711,0.702,2117,2013,14
2294,Central Conn St,2013-14,30,11,19,0.367,6049,781,1794,0.435,612,1290,0.474,169,504,0.335,386,538,0.717,2117,2013,14
2295,Northern Ky.,2014-15,30,13,17,0.433,6051,779,1693,0.46,553,1045,0.529,226,648,0.349,333,507,0.657,2117,2014,15
2296,Bowling Green,2010-11,33,14,19,0.424,6675,803,1859,0.432,657,1368,0.48,146,491,0.297,364,567,0.642,2116,2010,11
2297,West Virginia,2012-13,32,13,19,0.406,6425,722,1769,0.408,551,1228,0.449,171,541,0.316,501,721,0.695,2116,2012,13
2298,Drake,2013-14,31,15,16,0.484,6226,720,1592,0.452,481,989,0.486,239,603,0.396,437,612,0.714,2116,2013,14
2299,East Carolina,2014-15,33,14,19,0.424,6625,750,1777,0.422,517,1114,0.464,233,663,0.351,383,563,0.68,2116,2014,15
2300,Northern Ky.,2015-16,30,9,21,0.3,6051,755,1719,0.439,521,1063,0.49,234,656,0.357,372,545,0.683,2116,2015,16
,,,,,,,,School,School,School,School,School,School,School,School,School,School,School,School,School,,
,Schl,Season,G,W,L,W-L%,MP,FG,FGA,FG%,2P,2PA,2P%,3P,3PA,3P%,FT,FTA,FT%,PTS,Season,
2301,James Madison,2011-12,32,12,20,0.375,6450,748,1774,0.422,500,1098,0.455,248,676,0.367,371,557,0.666,2115,2011,12
2302,South Carolina,2012-13,32,14,18,0.438,6500,743,1802,0.412,551,1204,0.458,192,598,0.321,437,635,0.688,2115,2012,13
2303,High Point,2018-19,31,16,15,0.516,6274,763,1719,0.444,583,1136,0.513,180,583,0.309,409,605,0.676,2115,2018,19
2304,Santa Clara,2018-19,31,16,15,0.516,6275,735,1653,0.445,496,990,0.501,239,663,0.36,406,567,0.716,2115,2018,19
2305,Tx-Rio Grande,2010-11,31,6,25,0.194,6225,695,1638,0.424,452,1006,0.449,243,632,0.384,481,710,0.677,2114,2010,11
2306,Georgia State,2012-13,31,15,16,0.484,6275,739,1685,0.439,520,1074,0.484,219,611,0.358,417,586,0.712,2114,2012,13
2307,Rice,2017-18,31,7,24,0.226,6250,711,1751,0.406,451,933,0.483,260,818,0.318,432,646,0.669,2114,2017,18
2308,Navy,2010-11,31,11,20,0.355,6275,694,1765,0.393,458,963,0.476,236,802,0.294,489,690,0.709,2113,2010,11
2309,South Dakota,2012-13,30,10,20,0.333,6000,721,1607,0.449,513,1047,0.49,208,560,0.371,463,593,0.781,2113,2012,13
2310,Cincinnati,2014-15,34,23,11,0.676,6899,761,1705,0.446,594,1198,0.496,167,507,0.329,424,633,0.67,2113,2014,15
2311,Loyola Marymount,2016-17,30,15,15,0.5,6026,779,1755,0.444,562,1141,0.493,217,614,0.353,338,545,0.62,2113,2016,17
2312,Denver,2011-12,31,22,9,0.71,6275,728,1494,0.487,473,853,0.555,255,641,0.398,401,526,0.762,2112,2011,12
2313,Ga. Southern,2014-15,31,22,9,0.71,6250,733,1765,0.415,499,1025,0.487,234,740,0.316,412,616,0.669,2112,2014,15
2314,Oklahoma,2010-11,32,14,18,0.438,6450,738,1648,0.448,540,1061,0.509,198,587,0.337,437,592,0.738,2111,2010,11
2315,McNeese State,2013-14,31,11,20,0.355,6252,729,1857,0.393,526,1192,0.441,203,665,0.305,450,647,0.696,2111,2013,14
2316,Wofford,2011-12,33,19,14,0.576,6650,777,1792,0.434,559,1127,0.496,218,665,0.328,338,508,0.665,2110,2011,12
2317,St. Francis (PA),2015-16,30,13,17,0.433,6050,716,1700,0.421,498,1093,0.456,218,607,0.359,460,662,0.695,2110,2015,16
2318,Central Ark.,2015-16,28,7,21,0.25,5600,734,1656,0.443,549,1159,0.474,185,497,0.372,457,694,0.659,2110,2015,16
2319,St. Bonaventure,2012-13,29,14,15,0.483,5849,708,1579,0.448,496,1013,0.49,212,566,0.375,481,630,0.763,2109,2012,13
2320,Montana State,2013-14,31,14,17,0.452,6224,736,1661,0.443,551,1139,0.484,185,522,0.354,452,636,0.711,2109,2013,14
2321,Northeastern,2013-14,32,11,21,0.344,6475,734,1692,0.434,578,1211,0.477,156,481,0.324,485,752,0.645,2109,2013,14
2322,Missouri State,2011-12,32,16,16,0.5,6525,775,1778,0.436,589,1229,0.479,186,549,0.339,372,516,0.721,2108,2011,12
2323,St. Francis (NY),2012-13,30,12,18,0.4,6025,763,1789,0.426,557,1161,0.48,206,628,0.328,376,565,0.665,2108,2012,13
2324,Minnesota,2015-16,31,8,23,0.258,6275,724,1785,0.406,533,1169,0.456,191,616,0.31,469,662,0.708,2108,2015,16
2325,Fla. Atlantic,2016-17,30,10,20,0.333,6075,756,1838,0.411,552,1199,0.46,204,639,0.319,392,558,0.703,2108,2016,17
2326,Fordham,2018-19,32,12,20,0.375,6467,759,1890,0.402,483,1059,0.456,276,831,0.332,314,462,0.68,2108,2018,19
2327,Ark-Pine Bluff,2018-19,32,13,19,0.406,6500,719,1685,0.427,525,1111,0.473,194,574,0.338,476,702,0.678,2108,2018,19
2328,Northwestern,2018-19,32,13,19,0.406,6450,735,1827,0.402,502,1083,0.464,233,744,0.313,405,551,0.735,2108,2018,19
2329,NJIT,2013-14,29,13,16,0.448,5850,728,1638,0.444,512,1060,0.483,216,578,0.374,435,603,0.721,2107,2013,14
2330,Penn State,2015-16,32,16,16,0.5,6450,732,1799,0.407,521,1134,0.459,211,665,0.317,432,621,0.696,2107,2015,16
2331,Saint Louis,2015-16,32,11,21,0.344,6450,724,1726,0.419,525,1119,0.469,199,607,0.328,459,653,0.703,2106,2015,16
2332,Princeton,2017-18,29,13,16,0.448,6000,753,1661,0.453,466,894,0.521,287,767,0.374,313,443,0.707,2106,2017,18
2333,Loyola (IL),2013-14,32,10,22,0.313,6501,744,1609,0.462,553,1063,0.52,191,546,0.35,426,606,0.703,2105,2013,14
2334,Boston College,2014-15,32,13,19,0.406,6499,743,1668,0.445,536,1030,0.52,207,638,0.324,412,584,0.705,2105,2014,15
2335,Stephen F. Austin,2018-19,30,14,16,0.467,6043,745,1696,0.439,544,1108,0.491,201,588,0.342,414,607,0.682,2105,2018,19
2336,Wyoming,2018-19,32,8,24,0.25,6425,690,1656,0.417,442,936,0.472,248,720,0.344,477,660,0.723,2105,2018,19
2337,Rutgers,2018-19,31,14,17,0.452,6250,771,1842,0.419,580,1230,0.472,191,612,0.312,372,584,0.637,2105,2018,19
2338,DePaul,2010-11,31,7,24,0.226,6275,766,1800,0.426,603,1281,0.471,163,519,0.314,409,599,0.683,2104,2010,11
2339,Cal St Fullerton,2015-16,30,10,20,0.333,6027,698,1703,0.41,505,1121,0.45,193,582,0.332,515,743,0.693,2104,2015,16
2340,Hawaii,2017-18,30,17,13,0.567,6075,721,1630,0.442,519,1017,0.51,202,613,0.33,460,670,0.687,2104,2017,18
2341,Tennessee Tech,2018-19,31,8,23,0.258,6192,742,1784,0.416,529,1164,0.454,213,620,0.344,407,645,0.631,2104,2018,19
2342,Siena,2010-11,31,13,18,0.419,6275,762,1841,0.414,602,1362,0.442,160,479,0.334,419,617,0.679,2103,2010,11
2343,Gardner-Webb,2011-12,32,12,20,0.375,6477,749,1804,0.415,558,1190,0.469,191,614,0.311,414,620,0.668,2103,2011,12
2344,Texas A&M,2012-13,33,18,15,0.545,6750,767,1742,0.44,602,1279,0.471,165,463,0.356,404,573,0.705,2103,2012,13
2345,New Hampshire,2017-18,31,10,21,0.323,6200,725,1803,0.402,473,1027,0.461,252,776,0.325,401,544,0.737,2103,2017,18
2346,Georgia Tech,2010-11,31,13,18,0.419,6250,752,1855,0.405,560,1212,0.462,192,643,0.299,406,589,0.689,2102,2010,11
2347,Tx-Rio Grande,2012-13,32,16,16,0.5,6550,739,1713,0.431,529,1151,0.46,210,562,0.374,413,648,0.637,2101,2012,13
2348,USC,2012-13,32,14,18,0.438,6500,778,1826,0.426,612,1340,0.457,166,486,0.342,379,547,0.693,2101,2012,13
2349,Tx-Rio Grande,2013-14,32,9,23,0.281,6525,755,1828,0.413,600,1273,0.471,155,555,0.279,436,660,0.661,2101,2013,14
2350,Florida,2014-15,33,16,17,0.485,6652,766,1763,0.434,548,1089,0.503,218,674,0.323,351,553,0.635,2101,2014,15
2351,Georgia Tech,2017-18,32,13,19,0.406,6425,753,1770,0.425,597,1280,0.466,156,490,0.318,439,616,0.713,2101,2017,18
2352,UMKC,2010-11,30,16,14,0.533,6150,710,1629,0.436,478,961,0.497,232,668,0.347,448,677,0.662,2100,2010,11
2353,Fort Wayne,2011-12,30,11,19,0.367,6024,756,1676,0.451,592,1179,0.502,164,497,0.33,424,621,0.683,2100,2011,12
2354,La Salle,2013-14,31,15,16,0.484,6303,720,1743,0.413,543,1199,0.453,177,544,0.325,483,682,0.708,2100,2013,14
2355,South Florida,2013-14,32,12,20,0.375,6474,751,1729,0.434,654,1353,0.483,97,376,0.258,501,757,0.662,2100,2013,14
2356,Cal St Bakersfield,2014-15,33,14,19,0.424,6725,715,1703,0.42,529,1149,0.46,186,554,0.336,484,669,0.723,2100,2014,15
2357,Jacksonville St.,2015-16,31,8,23,0.258,6225,721,1792,0.402,478,1083,0.441,243,709,0.343,415,567,0.732,2100,2015,16
2358,Northern Ariz.,2017-18,32,5,27,0.156,6450,698,1750,0.399,520,1166,0.446,178,584,0.305,526,750,0.701,2100,2017,18
2359,San Jose State,2011-12,31,9,22,0.29,6350,715,1810,0.395,483,1109,0.436,232,701,0.331,437,586,0.746,2099,2011,12
2360,Illinois,2011-12,32,17,15,0.531,6475,767,1741,0.441,581,1130,0.514,186,611,0.304,378,529,0.715,2098,2011,12
2361,ETSU,2011-12,31,17,14,0.548,6198,768,1743,0.441,640,1332,0.48,128,411,0.311,434,684,0.635,2098,2011,12
2362,Furman,2014-15,33,11,22,0.333,6650,701,1636,0.428,485,978,0.496,216,658,0.328,480,717,0.669,2098,2014,15
2363,Vermont,2012-13,33,21,12,0.636,6600,711,1626,0.437,553,1135,0.487,158,491,0.322,517,729,0.709,2097,2012,13
2364,Eastern Ill.,2014-15,33,18,15,0.545,6650,746,1696,0.44,505,1053,0.48,241,643,0.375,364,558,0.652,2097,2014,15
2365,George Washington,2018-19,33,9,24,0.273,6700,745,1842,0.404,549,1211,0.453,196,631,0.311,411,600,0.685,2097,2018,19
2366,Fresno State,2010-11,31,14,17,0.452,6225,743,1740,0.427,560,1119,0.5,183,621,0.295,427,679,0.629,2096,2010,11
2367,Md.-East. Shore,2010-11,31,9,22,0.29,6300,752,1854,0.406,587,1286,0.456,165,568,0.29,427,654,0.653,2096,2010,11
2368,Jackson State,2010-11,32,17,15,0.531,6475,721,1719,0.419,533,1149,0.464,188,570,0.33,466,731,0.637,2096,2010,11
2369,UConn,2012-13,30,20,10,0.667,6225,727,1644,0.442,536,1083,0.495,191,561,0.34,451,607,0.743,2096,2012,13
2370,IUPUI,2012-13,32,6,26,0.188,6500,790,1785,0.443,568,1164,0.488,222,621,0.357,294,439,0.67,2096,2012,13
2371,Syracuse,2014-15,31,18,13,0.581,6250,763,1775,0.43,608,1260,0.483,155,515,0.301,415,629,0.66,2096,2014,15
2372,Rutgers,2011-12,32,14,18,0.438,6475,764,1802,0.424,595,1298,0.458,169,504,0.335,398,571,0.697,2095,2011,12
2373,Youngstown St.,2011-12,31,16,15,0.516,6248,746,1729,0.431,476,1021,0.466,270,708,0.381,333,514,0.648,2095,2011,12
2374,St. Francis (NY),2015-16,32,15,17,0.469,6450,710,1787,0.397,470,1011,0.465,240,776,0.309,435,652,0.667,2095,2015,16
2375,Evansville,2017-18,32,17,15,0.531,6425,731,1652,0.442,547,1204,0.454,184,448,0.411,448,578,0.775,2094,2017,18
2376,UTEP,2017-18,31,11,20,0.355,6200,754,1736,0.434,530,1069,0.496,224,667,0.336,362,542,0.668,2094,2017,18
2377,Tulsa,2011-12,31,17,14,0.548,6375,710,1577,0.45,532,1114,0.478,178,463,0.384,495,727,0.681,2093,2011,12
2378,Wake Forest,2012-13,31,13,18,0.419,6200,717,1652,0.434,549,1165,0.471,168,487,0.345,491,722,0.68,2093,2012,13
2379,Drake,2015-16,31,7,24,0.226,6275,736,1639,0.449,521,1080,0.482,215,559,0.385,406,562,0.722,2093,2015,16
2380,Presbyterian,2015-16,31,11,20,0.355,6225,754,1743,0.433,606,1241,0.488,148,502,0.295,437,615,0.711,2093,2015,16
2381,Colgate,2015-16,30,13,17,0.433,6100,747,1673,0.447,480,955,0.503,267,718,0.372,332,488,0.68,2093,2015,16
2382,Seton Hall,2010-11,31,13,18,0.419,6250,759,1838,0.413,572,1227,0.466,187,611,0.306,387,576,0.672,2092,2010,11
2383,Nevada,2012-13,31,12,19,0.387,6250,703,1671,0.421,520,1076,0.483,183,595,0.308,503,690,0.729,2092,2012,13
2384,Fla. Atlantic,2012-13,32,14,18,0.438,6500,732,1735,0.422,537,1194,0.45,195,541,0.36,433,618,0.701,2092,2012,13
2385,Central Mich.,2012-13,31,11,20,0.355,6250,680,1664,0.409,430,910,0.473,250,754,0.332,482,659,0.731,2092,2012,13
2386,Presbyterian,2013-14,32,6,26,0.188,6400,772,1724,0.448,582,1186,0.491,190,538,0.353,358,529,0.677,2092,2013,14
2387,Cal St Fullerton,2013-14,31,11,20,0.355,6226,734,1726,0.425,543,1149,0.473,191,577,0.331,433,658,0.658,2092,2013,14
2388,Quinnipiac,2014-15,30,15,15,0.5,6151,715,1813,0.394,550,1276,0.431,165,537,0.307,497,643,0.773,2092,2014,15
2389,DePaul,2015-16,31,9,22,0.29,6226,752,1691,0.445,584,1201,0.486,168,490,0.343,420,618,0.68,2092,2015,16
2390,Mt. St. Mary's,2018-19,31,9,22,0.29,6197,733,1755,0.418,510,1032,0.494,223,723,0.308,403,594,0.678,2092,2018,19
2391,Hofstra,2011-12,32,10,22,0.313,6400,700,1732,0.404,545,1266,0.43,155,466,0.333,536,747,0.718,2091,2011,12
2392,Maine,2013-14,29,6,23,0.207,5824,759,1712,0.443,577,1169,0.494,182,543,0.335,391,577,0.678,2091,2013,14
2393,Houston Baptist,2013-14,31,6,25,0.194,6250,737,1733,0.425,580,1277,0.454,157,456,0.344,460,674,0.682,2091,2013,14
2394,Seattle,2016-17,30,13,17,0.433,6125,713,1646,0.433,453,890,0.509,260,756,0.344,405,573,0.707,2091,2016,17
2395,La Salle,2018-19,31,10,21,0.323,6200,719,1798,0.4,460,1015,0.453,259,783,0.331,394,512,0.77,2091,2018,19
2396,Georgia Tech,2018-19,32,14,18,0.438,6425,755,1714,0.44,579,1141,0.507,176,573,0.307,405,588,0.689,2091,2018,19
2397,Ga. Southern,2010-11,32,5,27,0.156,6450,745,1661,0.449,603,1226,0.492,142,435,0.326,458,666,0.688,2090,2010,11
2398,Alabama State,2014-15,29,19,10,0.655,5825,761,1738,0.438,589,1258,0.468,172,480,0.358,396,609,0.65,2090,2014,15
2399,Loyola (MD),2015-16,30,9,21,0.3,6150,732,1702,0.43,571,1172,0.487,161,530,0.304,465,653,0.712,2090,2015,16
2400,Fordham,2016-17,32,13,19,0.406,6500,741,1783,0.416,477,992,0.481,264,791,0.334,344,474,0.726,2090,2016,17
,,,,,,,,School,School,School,School,School,School,School,School,School,School,School,School,School,,
,Schl,Season,G,W,L,W-L%,MP,FG,FGA,FG%,2P,2PA,2P%,3P,3PA,3P%,FT,FTA,FT%,PTS,Season,
2401,Radford,2016-17,32,14,18,0.438,6501,745,1802,0.413,498,1087,0.458,247,715,0.345,353,530,0.666,2090,2016,17
2402,SIU Edwardsville,2017-18,30,9,21,0.3,6000,734,1759,0.417,522,1105,0.472,212,654,0.324,410,580,0.707,2090,2017,18
2403,Maine,2010-11,30,15,15,0.5,6075,726,1576,0.461,535,1037,0.516,191,539,0.354,446,638,0.699,2089,2010,11
2404,Stetson,2011-12,29,9,20,0.31,5875,732,1660,0.441,503,993,0.507,229,667,0.343,396,570,0.695,2089,2011,12
2405,Savannah State,2011-12,33,21,12,0.636,6625,746,1791,0.417,554,1205,0.46,192,586,0.328,405,688,0.589,2089,2011,12
2406,N.C. A&T,2013-14,32,9,23,0.281,6475,622,1626,0.383,451,1062,0.425,171,564,0.303,674,964,0.699,2089,2013,14
2407,Morgan State,2015-16,31,9,22,0.29,6251,734,1854,0.396,573,1319,0.434,161,535,0.301,460,672,0.685,2089,2015,16
2408,Chicago State,2016-17,32,6,26,0.188,6500,739,1923,0.384,527,1242,0.424,212,681,0.311,399,569,0.701,2089,2016,17
2409,Stanford,2015-16,30,15,15,0.5,6050,704,1653,0.426,532,1115,0.477,172,538,0.32,508,742,0.685,2088,2015,16
2410,East Carolina,2016-17,33,15,18,0.455,6600,716,1797,0.398,502,1129,0.445,214,668,0.32,442,673,0.657,2088,2016,17
2411,Longwood,2017-18,33,7,26,0.212,6600,728,1764,0.413,502,1073,0.468,226,691,0.327,406,591,0.687,2088,2017,18
2412,East Carolina,2018-19,31,10,21,0.323,6275,749,1791,0.418,594,1246,0.477,155,545,0.284,435,638,0.682,2088,2018,19
2413,Bryant,2018-19,30,10,20,0.333,5999,709,1680,0.422,479,972,0.493,230,708,0.325,440,618,0.712,2088,2018,19
2414,SE Missouri St,2014-15,30,13,17,0.433,6025,742,1686,0.44,553,1133,0.488,189,553,0.342,414,621,0.667,2087,2014,15
2415,Miami (OH),2015-16,33,13,20,0.394,6600,719,1781,0.404,541,1199,0.451,178,582,0.306,471,646,0.729,2087,2015,16
2416,Fresno State,2014-15,32,15,17,0.469,6477,725,1692,0.428,546,1133,0.482,179,559,0.32,457,662,0.69,2086,2014,15
2417,La Salle,2014-15,33,17,16,0.515,6700,738,1757,0.42,572,1240,0.461,166,517,0.321,444,640,0.694,2086,2014,15
2418,Marist,2018-19,31,12,19,0.387,6250,739,1647,0.449,494,972,0.508,245,675,0.363,363,530,0.685,2086,2018,19
2419,Alabama State,2018-19,31,12,19,0.387,6250,712,1764,0.404,496,1091,0.455,216,673,0.321,446,684,0.652,2086,2018,19
2420,Denver,2018-19,30,8,22,0.267,6025,755,1723,0.438,528,1101,0.48,227,622,0.365,349,460,0.759,2086,2018,19
2421,Santa Clara,2011-12,30,8,22,0.267,6050,717,1751,0.409,478,1094,0.437,239,657,0.364,412,582,0.708,2085,2011,12
2422,Southeastern LA,2013-14,30,12,18,0.4,6051,714,1612,0.443,510,1052,0.485,204,560,0.364,453,650,0.697,2085,2013,14
2423,UMKC,2013-14,30,10,20,0.333,6000,729,1697,0.43,562,1145,0.491,167,552,0.303,460,725,0.634,2085,2013,14
2424,St. Bonaventure,2014-15,31,18,13,0.581,6250,733,1723,0.425,575,1220,0.471,158,503,0.314,461,653,0.706,2085,2014,15
2425,South Florida,2015-16,33,8,25,0.242,6600,774,1852,0.418,641,1387,0.462,133,465,0.286,404,612,0.66,2085,2015,16
2426,St. Peter's,2017-18,32,14,18,0.438,6550,740,1762,0.42,487,1012,0.481,253,750,0.337,352,488,0.721,2085,2017,18
2427,Iowa,2010-11,31,11,20,0.355,6250,766,1743,0.439,620,1278,0.485,146,465,0.314,406,601,0.676,2084,2010,11
2428,St. Francis (NY),2011-12,30,15,15,0.5,6025,727,1685,0.431,488,1013,0.482,239,672,0.356,391,590,0.663,2084,2011,12
2429,South Dakota,2013-14,30,12,18,0.4,6025,713,1613,0.442,522,1074,0.486,191,539,0.354,467,622,0.751,2084,2013,14
2430,Marquette,2014-15,32,13,19,0.406,6450,742,1699,0.437,535,1097,0.488,207,602,0.344,392,608,0.645,2083,2014,15
2431,Portland State,2014-15,29,15,14,0.517,5825,723,1645,0.44,530,1138,0.466,193,507,0.381,444,598,0.742,2083,2014,15
2432,McNeese State,2015-16,29,9,20,0.31,5925,719,1751,0.411,514,1134,0.453,205,617,0.332,440,629,0.7,2083,2015,16
2433,Santa Clara,2015-16,31,11,20,0.355,6325,713,1741,0.41,481,1066,0.451,232,675,0.344,425,592,0.718,2083,2015,16
2434,Cleveland State,2016-17,31,9,22,0.29,6300,745,1838,0.405,526,1129,0.466,219,709,0.309,374,541,0.691,2083,2016,17
2435,Robert Morris,2015-16,32,10,22,0.313,6425,741,1780,0.416,563,1135,0.496,178,645,0.276,422,633,0.667,2082,2015,16
2436,Cal Poly,2016-17,31,11,20,0.355,6250,726,1800,0.403,468,1042,0.449,258,758,0.34,372,534,0.697,2082,2016,17
2437,Cal Poly,2017-18,31,9,22,0.29,6350,721,1817,0.397,454,1071,0.424,267,746,0.358,373,478,0.78,2082,2017,18
2438,Tulane,2018-19,31,4,27,0.129,6200,733,1783,0.411,520,1113,0.467,213,670,0.318,403,585,0.689,2082,2018,19
2439,American,2013-14,33,20,13,0.606,6626,748,1527,0.49,541,981,0.551,207,546,0.379,378,535,0.707,2081,2013,14
2440,St. Peter's,2014-15,34,16,18,0.471,6900,698,1695,0.412,505,1132,0.446,193,563,0.343,492,745,0.66,2081,2014,15
2441,VMI,2015-16,30,9,21,0.3,6025,729,1770,0.412,466,987,0.472,263,783,0.336,360,498,0.723,2081,2015,16
2442,LIU,2013-14,29,9,20,0.31,5827,707,1653,0.428,489,1022,0.478,218,631,0.345,448,625,0.717,2080,2013,14
2443,Brown,2017-18,27,11,16,0.407,5501,695,1631,0.426,509,1043,0.488,186,588,0.316,504,667,0.756,2080,2017,18
2444,Montana State,2010-11,31,13,18,0.419,6225,716,1730,0.414,481,1024,0.47,235,706,0.333,412,637,0.647,2079,2010,11
2445,San Diego,2011-12,31,13,18,0.419,6225,744,1648,0.451,545,1100,0.495,199,548,0.363,392,598,0.656,2079,2011,12
2446,Lipscomb,2012-13,30,12,18,0.4,6075,717,1690,0.424,558,1193,0.468,159,497,0.32,486,751,0.647,2079,2012,13
2447,Yale,2012-13,31,14,17,0.452,6300,697,1620,0.43,513,1096,0.468,184,524,0.351,501,688,0.728,2079,2012,13
2448,N.C. Central,2012-13,31,22,9,0.71,6200,706,1536,0.46,538,1053,0.511,168,483,0.348,499,680,0.734,2079,2012,13
2449,Utah,2010-11,31,13,18,0.419,6200,734,1724,0.426,553,1178,0.469,181,546,0.332,429,618,0.694,2078,2010,11
2450,Portland,2018-19,32,7,25,0.219,6450,707,1708,0.414,491,1044,0.47,216,664,0.325,448,668,0.671,2078,2018,19
2451,Southern Utah,2010-11,30,11,19,0.367,6000,736,1572,0.468,639,1288,0.496,97,284,0.342,508,716,0.709,2077,2010,11
2452,Southern,2018-19,32,7,25,0.219,6427,752,1710,0.44,572,1166,0.491,180,544,0.331,393,588,0.668,2077,2018,19
2453,Bradley,2010-11,32,12,20,0.375,6425,748,1751,0.427,589,1275,0.462,159,476,0.334,421,583,0.722,2076,2010,11
2454,Troy,2010-11,29,8,21,0.276,5950,733,1796,0.408,478,1053,0.454,255,743,0.343,355,536,0.662,2076,2010,11
2455,Denver,2012-13,32,22,10,0.688,6425,739,1540,0.48,487,868,0.561,252,672,0.375,346,481,0.719,2076,2012,13
2456,Navy,2016-17,32,16,16,0.5,6425,735,1740,0.422,529,1070,0.494,206,670,0.307,400,624,0.641,2076,2016,17
2457,Stephen F. Austin,2012-13,32,27,5,0.844,6400,772,1649,0.468,638,1236,0.516,134,413,0.324,397,651,0.61,2075,2012,13
2458,North Texas,2016-17,30,8,22,0.267,6025,740,1747,0.424,554,1165,0.476,186,582,0.32,409,633,0.646,2075,2016,17
2459,Northern Colo.,2016-17,29,11,18,0.379,5850,732,1666,0.439,478,934,0.512,254,732,0.347,357,590,0.605,2075,2016,17
2460,Miss Val St,2017-18,32,4,28,0.125,6499,758,1979,0.383,587,1411,0.416,171,568,0.301,388,575,0.675,2075,2017,18
2461,Air Force,2010-11,32,16,16,0.5,6475,722,1532,0.471,510,969,0.526,212,563,0.377,418,593,0.705,2074,2010,11
2462,Auburn,2012-13,32,9,23,0.281,6525,726,1777,0.409,543,1188,0.457,183,589,0.311,439,627,0.7,2074,2012,13
2463,Cal Poly,2012-13,32,18,14,0.563,6450,719,1696,0.424,492,1090,0.451,227,606,0.375,409,564,0.725,2074,2012,13
2464,Wyoming,2012-13,34,20,14,0.588,6850,707,1655,0.427,483,960,0.503,224,695,0.322,436,646,0.675,2074,2012,13
2465,Seattle,2015-16,32,15,17,0.469,6425,735,1732,0.424,538,1182,0.455,197,550,0.358,407,612,0.665,2074,2015,16
2466,Cornell,2016-17,29,8,21,0.276,5826,746,1646,0.453,502,926,0.542,244,720,0.339,338,484,0.698,2074,2016,17
2467,Youngstown St.,2010-11,30,9,21,0.3,6075,756,1823,0.415,521,1115,0.467,235,708,0.332,325,533,0.61,2072,2010,11
2468,Fairfield,2018-19,31,9,22,0.29,6200,761,1755,0.434,502,1015,0.495,259,740,0.35,291,420,0.693,2072,2018,19
2469,UIC,2013-14,31,6,25,0.194,6201,714,1696,0.421,542,1171,0.463,172,525,0.328,471,660,0.714,2071,2013,14
2470,Michigan,2014-15,32,16,16,0.5,6549,734,1724,0.426,484,1028,0.471,250,696,0.359,353,468,0.754,2071,2014,15
2471,Morehead State,2011-12,33,18,15,0.545,6600,701,1621,0.432,486,1022,0.476,215,599,0.359,453,608,0.745,2070,2011,12
2472,Georgetown,2012-13,32,25,7,0.781,6500,737,1627,0.453,548,1091,0.502,189,536,0.353,407,599,0.679,2070,2012,13
2473,Sacramento St.,2013-14,30,14,16,0.467,6050,735,1598,0.46,552,1107,0.499,183,491,0.373,417,575,0.725,2070,2013,14
2474,Liberty,2015-16,32,13,19,0.406,6401,738,1644,0.449,455,870,0.523,283,774,0.366,311,434,0.717,2070,2015,16
2475,St. Peter's,2010-11,34,20,14,0.588,6828,713,1782,0.4,516,1209,0.427,197,573,0.344,446,693,0.644,2069,2010,11
2476,Maine,2016-17,32,7,25,0.219,6398,746,1852,0.403,534,1187,0.45,212,665,0.319,365,558,0.654,2069,2016,17
2477,Wyoming,2011-12,33,21,12,0.636,6625,710,1585,0.448,513,983,0.522,197,602,0.327,451,610,0.739,2068,2011,12
2478,Niagara,2015-16,32,7,25,0.219,6479,735,1821,0.404,569,1232,0.462,166,589,0.282,431,620,0.695,2067,2015,16
2479,Southern Utah,2012-13,31,11,20,0.355,6251,718,1768,0.406,556,1265,0.44,162,503,0.322,468,646,0.724,2066,2012,13
2480,UTSA,2013-14,30,8,22,0.267,6025,654,1545,0.423,473,998,0.474,181,547,0.331,577,836,0.69,2066,2013,14
2481,Alcorn State,2014-15,32,6,26,0.188,6399,724,1864,0.388,569,1311,0.434,155,553,0.28,463,704,0.658,2066,2014,15
2482,Princeton,2014-15,30,16,14,0.533,6000,673,1455,0.463,421,787,0.535,252,668,0.377,468,658,0.711,2066,2014,15
2483,Jackson State,2016-17,32,14,18,0.438,6451,716,1860,0.385,499,1130,0.442,217,730,0.297,417,619,0.674,2066,2016,17
2484,Charlotte,2017-18,29,6,23,0.207,5820,706,1634,0.432,508,1071,0.474,198,563,0.352,456,637,0.716,2066,2017,18
2485,NJIT,2010-11,30,15,15,0.5,6049,743,1734,0.428,521,1124,0.464,222,610,0.364,357,578,0.618,2065,2010,11
2486,Seattle,2011-12,27,12,15,0.444,5425,779,1792,0.435,588,1214,0.484,191,578,0.33,316,454,0.696,2065,2011,12
2487,Brown,2013-14,29,15,14,0.517,5849,735,1705,0.431,539,1190,0.453,196,515,0.381,399,593,0.673,2065,2013,14
2488,Eastern Ill.,2017-18,31,12,19,0.387,6225,732,1726,0.424,508,1099,0.462,224,627,0.357,377,551,0.684,2065,2017,18
2489,Northeastern,2010-11,31,11,20,0.355,6250,719,1610,0.447,526,1101,0.478,193,509,0.379,433,577,0.75,2064,2010,11
2490,William & Mary,2012-13,30,13,17,0.433,6150,718,1536,0.467,495,945,0.524,223,591,0.377,405,571,0.709,2064,2012,13
2491,SMU,2012-13,32,15,17,0.469,6425,729,1624,0.449,616,1296,0.475,113,328,0.345,493,662,0.745,2064,2012,13
2492,Drexel,2013-14,30,16,14,0.533,6224,718,1707,0.421,564,1216,0.464,154,491,0.314,474,669,0.709,2064,2013,14
2493,Stetson,2014-15,31,9,22,0.29,6200,744,1717,0.433,551,1131,0.487,193,586,0.329,383,583,0.657,2064,2014,15
2494,Utah State,2014-15,31,18,13,0.581,6275,721,1596,0.452,488,1005,0.486,233,591,0.394,389,579,0.672,2064,2014,15
2495,N.C. Central,2010-11,30,15,15,0.5,6075,722,1606,0.45,523,1044,0.501,199,562,0.354,419,607,0.69,2062,2010,11
2496,New Orleans,2014-15,29,11,18,0.379,5850,704,1604,0.439,581,1238,0.469,123,366,0.336,531,770,0.69,2062,2014,15
2497,UCF,2015-16,30,12,18,0.4,6050,715,1663,0.43,508,1013,0.501,207,650,0.318,425,619,0.687,2062,2015,16
2498,Columbia,2017-18,27,8,19,0.296,5450,746,1686,0.442,477,953,0.501,269,733,0.367,301,407,0.74,2062,2017,18
2499,Houston,2010-11,30,12,18,0.4,6125,726,1580,0.459,550,1128,0.488,176,452,0.389,433,647,0.669,2061,2010,11
2500,Morgan State,2010-11,31,17,14,0.548,6200,708,1687,0.42,585,1271,0.46,123,416,0.296,522,766,0.681,2061,2010,11
,,,,,,,,School,School,School,School,School,School,School,School,School,School,School,School,School,,
,Schl,Season,G,W,L,W-L%,MP,FG,FGA,FG%,2P,2PA,2P%,3P,3PA,3P%,FT,FTA,FT%,PTS,Season,
2501,Washington St.,2012-13,32,13,19,0.406,6450,717,1681,0.427,485,1012,0.479,232,669,0.347,395,574,0.688,2061,2012,13
2502,Tennessee State,2013-14,30,5,25,0.167,6024,707,1647,0.429,560,1145,0.489,147,502,0.293,500,714,0.7,2061,2013,14
2503,St. Francis (PA),2014-15,32,16,16,0.5,6450,724,1653,0.438,498,976,0.51,226,677,0.334,387,576,0.672,2061,2014,15
2504,Navy,2018-19,31,12,19,0.387,6199,732,1785,0.41,524,1129,0.464,208,656,0.317,389,544,0.715,2061,2018,19
2505,South Alabama,2012-13,30,17,13,0.567,6050,679,1655,0.41,508,1127,0.451,171,528,0.324,531,741,0.717,2060,2012,13
2506,FIU,2014-15,33,16,17,0.485,6675,749,1694,0.442,598,1207,0.495,151,487,0.31,411,647,0.635,2060,2014,15
2507,Indiana State,2014-15,31,15,16,0.484,6326,681,1601,0.425,456,970,0.47,225,631,0.357,473,674,0.702,2060,2014,15
2508,Houston,2014-15,32,13,19,0.406,6500,705,1795,0.393,446,986,0.452,259,809,0.32,391,575,0.68,2060,2014,15
2509,American,2011-12,32,20,12,0.625,6425,713,1678,0.425,486,1102,0.441,227,576,0.394,406,567,0.716,2059,2011,12
2510,Columbia,2018-19,28,10,18,0.357,5800,778,1720,0.452,541,1065,0.508,237,655,0.362,266,377,0.706,2059,2018,19
2511,Stanford,2010-11,31,15,16,0.484,6225,722,1676,0.431,524,1120,0.468,198,556,0.356,416,632,0.658,2058,2010,11
2512,Central Ark.,2011-12,29,8,21,0.276,5900,786,1884,0.417,636,1394,0.456,150,490,0.306,336,605,0.555,2058,2011,12
2513,Bryant,2014-15,31,16,15,0.516,6274,709,1683,0.421,483,1030,0.469,226,653,0.346,414,552,0.75,2058,2014,15
2514,Jacksonville,2014-15,32,10,22,0.313,6500,701,1710,0.41,498,1144,0.435,203,566,0.359,453,685,0.661,2058,2014,15
2515,Miss Val St,2018-19,32,6,26,0.188,6423,730,1923,0.38,558,1369,0.408,172,554,0.31,426,647,0.658,2058,2018,19
2516,Tulane,2010-11,30,13,17,0.433,6025,708,1646,0.43,478,1014,0.471,230,632,0.364,411,597,0.688,2057,2010,11
2517,VMI,2016-17,30,6,24,0.2,6000,732,1778,0.412,484,992,0.488,248,786,0.316,345,500,0.69,2057,2016,17
2518,Texas Southern,2010-11,32,19,13,0.594,6475,691,1622,0.426,506,1008,0.502,185,614,0.301,489,774,0.632,2056,2010,11
2519,N.C. A&T,2016-17,32,3,29,0.094,6500,728,1716,0.424,528,1106,0.477,200,610,0.328,400,587,0.681,2056,2016,17
2520,Northern Iowa,2017-18,32,16,16,0.5,6425,720,1714,0.42,491,1030,0.477,229,684,0.335,387,537,0.721,2056,2017,18
2521,Florida A&M,2010-11,32,12,20,0.375,6500,713,1787,0.399,519,1163,0.446,194,624,0.311,435,718,0.606,2055,2010,11
2522,Louisiana,2010-11,29,14,15,0.483,5875,715,1639,0.436,564,1204,0.468,151,435,0.347,474,715,0.663,2055,2010,11
2523,Northern Ill.,2010-11,30,9,21,0.3,6050,713,1694,0.421,539,1157,0.466,174,537,0.324,455,653,0.697,2055,2010,11
2524,Texas-Arlington,2010-11,29,13,16,0.448,5875,712,1616,0.441,500,1009,0.496,212,607,0.349,419,594,0.705,2055,2010,11
2525,McNeese State,2012-13,31,14,17,0.452,6355,771,1847,0.417,611,1362,0.449,160,485,0.33,353,549,0.643,2055,2012,13
2526,Alcorn State,2012-13,34,10,24,0.294,6828,726,1888,0.385,561,1326,0.423,165,562,0.294,438,705,0.621,2055,2012,13
2527,Idaho State,2013-14,29,11,18,0.379,5874,694,1547,0.449,528,1094,0.483,166,453,0.366,500,701,0.713,2054,2013,14
2528,Northern Ariz.,2015-16,30,5,25,0.167,6126,699,1749,0.4,479,1099,0.436,220,650,0.338,436,619,0.704,2054,2015,16
2529,Towson,2010-11,30,4,26,0.133,6050,715,1633,0.438,536,1130,0.474,179,503,0.356,444,614,0.723,2053,2010,11
2530,Loyola (IL),2015-16,32,15,17,0.469,6475,722,1700,0.425,526,1135,0.463,196,565,0.347,413,565,0.731,2053,2015,16
2531,Wagner,2014-15,30,10,20,0.333,6099,722,1804,0.4,543,1230,0.441,179,574,0.312,429,616,0.696,2052,2014,15
2532,Rice,2014-15,32,12,20,0.375,6575,679,1615,0.42,390,818,0.477,289,797,0.363,405,548,0.739,2052,2014,15
2533,Louisiana Tech,2010-11,32,12,20,0.375,6400,721,1721,0.419,528,1136,0.465,193,585,0.33,416,642,0.648,2051,2010,11
2534,American,2010-11,31,22,9,0.71,6300,716,1602,0.447,528,1045,0.505,188,557,0.338,431,600,0.718,2051,2010,11
2535,William & Mary,2010-11,32,10,22,0.313,6425,701,1584,0.443,451,895,0.504,250,689,0.363,399,572,0.698,2051,2010,11
2536,Cleveland State,2012-13,32,14,18,0.438,6424,733,1734,0.423,527,1133,0.465,206,601,0.343,379,535,0.708,2051,2012,13
2537,NW St.,2018-19,31,11,20,0.355,6250,725,1790,0.405,535,1144,0.468,190,646,0.294,411,604,0.68,2051,2018,19
2538,High Point,2010-11,31,12,19,0.387,6275,705,1711,0.412,535,1220,0.439,170,491,0.346,470,707,0.665,2050,2010,11
2539,Boise State,2011-12,30,13,17,0.433,6025,708,1653,0.428,481,989,0.486,227,664,0.342,407,589,0.691,2050,2011,12
2540,Idaho,2012-13,30,12,18,0.4,6051,715,1532,0.467,523,1010,0.518,192,522,0.368,428,576,0.743,2050,2012,13
2541,Ga. Southern,2012-13,33,14,19,0.424,6675,721,1721,0.419,536,1179,0.455,185,542,0.341,423,615,0.688,2050,2012,13
2542,Citadel,2010-11,32,10,22,0.313,6425,752,1758,0.428,595,1270,0.469,157,488,0.322,388,542,0.716,2049,2010,11
2543,Harvard,2012-13,30,20,10,0.667,6077,677,1425,0.475,486,945,0.514,191,480,0.398,504,697,0.723,2049,2012,13
2544,UTSA,2012-13,32,10,22,0.313,6424,693,1729,0.401,457,1023,0.447,236,706,0.334,426,630,0.676,2048,2012,13
2545,Brown,2014-15,31,13,18,0.419,6225,686,1623,0.423,511,1074,0.476,175,549,0.319,501,727,0.689,2048,2014,15
2546,Santa Clara,2017-18,31,11,20,0.355,6225,718,1674,0.429,486,992,0.49,232,682,0.34,380,524,0.725,2048,2017,18
2547,Wagner,2016-17,30,16,14,0.533,6075,727,1700,0.428,544,1148,0.474,183,552,0.332,410,593,0.691,2047,2016,17
2548,IUPUI,2017-18,30,11,19,0.367,6025,731,1723,0.424,518,1123,0.461,213,600,0.355,372,559,0.665,2047,2017,18
2549,Eastern Ky.,2010-11,31,15,16,0.484,6250,707,1584,0.446,460,913,0.504,247,671,0.368,385,519,0.742,2046,2010,11
2550,Troy,2012-13,33,12,21,0.364,6777,758,1907,0.397,546,1227,0.445,212,680,0.312,318,468,0.679,2046,2012,13
2551,Texas State,2015-16,31,15,16,0.484,6250,727,1692,0.43,578,1233,0.469,149,459,0.325,443,658,0.673,2046,2015,16
2552,Boston U.,2011-12,32,16,16,0.5,6425,725,1717,0.422,523,1083,0.483,202,634,0.319,393,583,0.674,2045,2011,12
2553,Marist,2012-13,31,10,21,0.323,6275,710,1670,0.425,513,1101,0.466,197,569,0.346,428,661,0.648,2045,2012,13
2554,Campbell,2014-15,32,10,22,0.313,6426,705,1654,0.426,443,918,0.483,262,736,0.356,373,597,0.625,2045,2014,15
2555,Miss Val St,2014-15,32,6,26,0.188,6478,738,1911,0.386,581,1392,0.417,157,519,0.303,412,630,0.654,2045,2014,15
2556,Liberty,2014-15,32,8,24,0.25,6425,717,1658,0.432,563,1186,0.475,154,472,0.326,457,650,0.703,2045,2014,15
2557,Tennessee State,2010-11,30,14,16,0.467,6070,676,1587,0.426,460,1001,0.46,216,586,0.369,476,625,0.762,2044,2010,11
2558,UC-Riverside,2010-11,31,12,19,0.387,6275,745,1757,0.424,584,1293,0.452,161,464,0.347,393,576,0.682,2044,2010,11
2559,South Florida,2010-11,33,10,23,0.303,6700,711,1710,0.416,552,1186,0.465,159,524,0.303,463,652,0.71,2044,2010,11
2560,Wyoming,2010-11,31,10,21,0.323,6200,720,1671,0.431,565,1122,0.504,155,549,0.282,449,667,0.673,2044,2010,11
2561,Northern Ky.,2013-14,30,9,21,0.3,6076,704,1618,0.435,476,964,0.494,228,654,0.349,408,578,0.706,2044,2013,14
2562,Denver,2013-14,31,16,15,0.516,6300,711,1535,0.463,458,881,0.52,253,654,0.387,369,520,0.71,2044,2013,14
2563,SIU Edwardsville,2016-17,30,6,24,0.2,6051,687,1686,0.407,545,1200,0.454,142,486,0.292,528,780,0.677,2044,2016,17
2564,Incarnate Word,2018-19,31,6,25,0.194,6276,711,1527,0.466,537,1019,0.527,174,508,0.343,448,553,0.81,2044,2018,19
2565,Canisius,2010-11,30,15,15,0.5,6000,739,1742,0.424,508,1080,0.47,231,662,0.349,334,478,0.699,2043,2010,11
2566,McNeese State,2016-17,29,7,22,0.241,5825,715,1697,0.421,520,1110,0.468,195,587,0.332,418,610,0.685,2043,2016,17
2567,Morehead State,2017-18,29,8,21,0.276,5825,712,1655,0.43,508,1024,0.496,204,631,0.323,415,592,0.701,2043,2017,18
2568,UTEP,2012-13,32,18,14,0.563,6500,706,1571,0.449,529,1067,0.496,177,504,0.351,453,669,0.677,2042,2012,13
2569,NJIT,2012-13,29,16,13,0.552,5950,702,1667,0.421,519,1172,0.443,183,495,0.37,455,678,0.671,2042,2012,13
2570,Lehigh,2014-15,30,16,14,0.533,6074,724,1640,0.441,560,1165,0.481,164,475,0.345,430,593,0.725,2042,2014,15
2571,Hawaii,2016-17,30,14,16,0.467,6050,698,1650,0.423,484,992,0.488,214,658,0.325,432,604,0.715,2042,2016,17
2572,Alabama State,2016-17,31,8,23,0.258,6299,719,1834,0.392,519,1160,0.447,200,674,0.297,404,634,0.637,2042,2016,17
2573,San Jose State,2018-19,31,4,27,0.129,6249,713,1765,0.404,503,1124,0.448,210,641,0.328,406,620,0.655,2042,2018,19
2574,Cal St Bakersfield,2012-13,30,14,16,0.467,6100,710,1697,0.418,511,1106,0.462,199,591,0.337,422,603,0.7,2041,2012,13
2575,Jackson State,2013-14,31,11,20,0.355,6254,711,1707,0.417,590,1294,0.456,121,413,0.293,498,688,0.724,2041,2013,14
2576,Cornell,2012-13,31,13,18,0.419,6200,732,1727,0.424,524,1118,0.469,208,609,0.342,368,523,0.704,2040,2012,13
2577,Brown,2015-16,28,8,20,0.286,5700,697,1625,0.429,472,986,0.479,225,639,0.352,421,600,0.702,2040,2015,16
2578,Army,2010-11,30,11,19,0.367,6000,707,1701,0.416,443,976,0.454,264,725,0.364,360,507,0.71,2038,2010,11
2579,Pacific,2010-11,31,16,15,0.516,6250,705,1606,0.439,469,943,0.497,236,663,0.356,392,558,0.703,2038,2010,11
2580,Southern Utah,2011-12,31,14,17,0.452,6275,755,1594,0.474,673,1318,0.511,82,276,0.297,446,617,0.723,2038,2011,12
2581,Little Rock,2017-18,32,7,25,0.219,6500,750,1756,0.427,550,1133,0.485,200,623,0.321,338,554,0.61,2038,2017,18
2582,UC-Davis,2018-19,31,11,20,0.355,6300,735,1673,0.439,532,1054,0.505,203,619,0.328,365,515,0.709,2038,2018,19
2583,Air Force,2014-15,31,14,17,0.452,6225,742,1565,0.474,510,940,0.543,232,625,0.371,321,487,0.659,2037,2014,15
2584,Boston U.,2014-15,30,13,17,0.433,6050,668,1498,0.446,436,867,0.503,232,631,0.368,469,674,0.696,2037,2014,15
2585,Sacred Heart,2012-13,29,9,20,0.31,5850,729,1656,0.44,536,1107,0.484,193,549,0.352,385,533,0.722,2036,2012,13
2586,Bradley,2013-14,32,12,20,0.375,6397,721,1720,0.419,567,1241,0.457,154,479,0.322,440,628,0.701,2036,2013,14
2587,Winthrop,2011-12,32,12,20,0.375,6476,754,1793,0.421,597,1287,0.464,157,506,0.31,370,564,0.656,2035,2011,12
2588,Boston U.,2012-13,30,17,13,0.567,6051,739,1647,0.449,499,999,0.499,240,648,0.37,317,436,0.727,2035,2012,13
2589,Coppin State,2012-13,32,8,24,0.25,6500,687,1878,0.366,444,1110,0.4,243,768,0.316,418,601,0.696,2035,2012,13
2590,Fairl. Dickinson,2012-13,31,7,24,0.226,6252,724,1675,0.432,534,1132,0.472,190,543,0.35,396,590,0.671,2034,2012,13
2591,App. St.,2013-14,30,9,21,0.3,6049,719,1730,0.416,568,1230,0.462,151,500,0.302,445,697,0.638,2034,2013,14
2592,Towson,2014-15,32,12,20,0.375,6500,689,1678,0.411,555,1249,0.444,134,429,0.312,522,787,0.663,2034,2014,15
2593,Delaware State,2017-18,32,4,28,0.125,6500,742,1781,0.417,550,1190,0.462,192,591,0.325,358,516,0.694,2034,2017,18
2594,Harvard,2011-12,31,26,5,0.839,6225,695,1490,0.466,510,972,0.525,185,518,0.357,458,613,0.747,2033,2011,12
2595,Colgate,2012-13,32,11,21,0.344,6421,735,1760,0.418,515,1116,0.461,220,644,0.342,343,485,0.707,2033,2012,13
2596,Campbell,2010-11,31,12,19,0.387,6225,742,1640,0.452,619,1289,0.48,123,351,0.35,425,663,0.641,2032,2010,11
2597,Bethune-Cookman,2013-14,32,7,25,0.219,6451,686,1713,0.4,468,1100,0.425,218,613,0.356,442,615,0.719,2032,2013,14
2598,Howard,2014-15,32,16,16,0.5,6500,695,1621,0.429,546,1120,0.488,149,501,0.297,493,705,0.699,2032,2014,15
2599,North Dakota,2014-15,30,8,22,0.267,6054,713,1637,0.436,533,1094,0.487,180,543,0.331,426,628,0.678,2032,2014,15
2600,Southeastern LA,2010-11,29,15,14,0.517,5825,705,1614,0.437,524,1086,0.483,181,528,0.343,440,610,0.721,2031,2010,11
,,,,,,,,School,School,School,School,School,School,School,School,School,School,School,School,School,,
,Schl,Season,G,W,L,W-L%,MP,FG,FGA,FG%,2P,2PA,2P%,3P,3PA,3P%,FT,FTA,FT%,PTS,Season,
2601,Western Ill.,2011-12,33,18,15,0.545,6725,744,1626,0.458,570,1185,0.481,174,441,0.395,369,538,0.686,2031,2011,12
2602,Northwestern,2014-15,32,15,17,0.469,6525,727,1669,0.436,499,1034,0.483,228,635,0.359,349,477,0.732,2031,2014,15
2603,Montana State,2011-12,29,12,17,0.414,5850,709,1669,0.425,511,1104,0.463,198,565,0.35,414,598,0.692,2030,2011,12
2604,Fairfield,2013-14,32,7,25,0.219,6426,697,1753,0.398,477,1093,0.436,220,660,0.333,416,607,0.685,2030,2013,14
2605,Eastern Ill.,2013-14,30,11,19,0.367,6000,703,1598,0.44,551,1122,0.491,152,476,0.319,472,660,0.715,2030,2013,14
2606,Kennesaw State,2018-19,32,6,26,0.188,6425,742,1945,0.381,606,1507,0.402,136,438,0.311,410,590,0.695,2030,2018,19
2607,Wagner,2010-11,30,13,17,0.433,6100,671,1544,0.435,475,1015,0.468,196,529,0.371,491,636,0.772,2029,2010,11
2608,Central Conn St,2011-12,29,13,16,0.448,5875,717,1689,0.425,537,1165,0.461,180,524,0.344,415,547,0.759,2029,2011,12
2609,Wake Forest,2011-12,31,13,18,0.419,6200,689,1613,0.427,523,1114,0.469,166,499,0.333,485,659,0.736,2029,2011,12
2610,Miami (FL),2013-14,33,17,16,0.515,6723,712,1690,0.421,526,1114,0.472,186,576,0.323,419,610,0.687,2029,2013,14
2611,Duquesne,2012-13,30,8,22,0.267,6050,714,1747,0.409,470,1025,0.459,244,722,0.338,356,553,0.644,2028,2012,13
2612,Houston Baptist,2014-15,28,12,16,0.429,5628,728,1596,0.456,599,1197,0.5,129,399,0.323,443,611,0.725,2028,2014,15
2613,Ohio,2014-15,30,10,20,0.333,6024,727,1678,0.433,510,1041,0.49,217,637,0.341,357,486,0.735,2028,2014,15
2614,Charleston,2015-16,31,17,14,0.548,6250,722,1718,0.42,516,1123,0.459,206,595,0.346,378,567,0.667,2028,2015,16
2615,South Carolina,2010-11,30,14,16,0.467,6100,741,1878,0.395,534,1216,0.439,207,662,0.313,338,510,0.663,2027,2010,11
2616,Army,2011-12,30,12,18,0.4,6075,678,1608,0.422,440,937,0.47,238,671,0.355,433,596,0.727,2027,2011,12
2617,Rutgers,2012-13,31,15,16,0.484,6200,747,1689,0.442,597,1269,0.47,150,420,0.357,383,548,0.699,2027,2012,13
2618,Santa Clara,2014-15,32,14,18,0.438,6425,711,1675,0.424,489,1039,0.471,222,636,0.349,383,520,0.737,2027,2014,15
2619,Kennesaw State,2014-15,32,10,22,0.313,6400,717,1775,0.404,503,1114,0.452,214,661,0.324,379,518,0.732,2027,2014,15
2620,Northern Colo.,2011-12,28,9,19,0.321,5703,699,1454,0.481,500,1006,0.497,199,448,0.444,429,614,0.699,2026,2011,12
2621,Texas Tech,2012-13,31,11,20,0.355,6225,721,1712,0.421,572,1195,0.479,149,517,0.288,435,652,0.667,2026,2012,13
2622,Saint Louis,2016-17,33,12,21,0.364,6650,700,1733,0.404,470,1061,0.443,230,672,0.342,396,597,0.663,2026,2016,17
2623,South Florida,2017-18,32,10,22,0.313,6425,707,1690,0.418,500,1117,0.448,207,573,0.361,405,560,0.723,2026,2017,18
2624,North Texas,2014-15,31,14,17,0.452,6226,726,1678,0.433,579,1189,0.487,147,489,0.301,426,677,0.629,2025,2014,15
2625,Tennessee,2014-15,32,16,16,0.5,6425,725,1706,0.425,531,1120,0.474,194,586,0.331,381,551,0.691,2025,2014,15
2626,UC-Riverside,2014-15,31,14,17,0.452,6275,707,1691,0.418,500,1088,0.46,207,603,0.343,404,592,0.682,2025,2014,15
2627,Morgan State,2016-17,30,14,16,0.467,6050,691,1793,0.385,532,1252,0.425,159,541,0.294,484,681,0.711,2025,2016,17
2628,San Diego,2016-17,31,13,18,0.419,6325,666,1636,0.407,408,895,0.456,258,741,0.348,435,603,0.721,2025,2016,17
2629,UC-Riverside,2017-18,31,9,22,0.29,6225,716,1779,0.402,531,1182,0.449,185,597,0.31,407,580,0.702,2024,2017,18
2630,Eastern Wash.,2010-11,30,10,20,0.333,6050,688,1685,0.408,446,1029,0.433,242,656,0.369,405,611,0.663,2023,2010,11
2631,Loyola (MD),2010-11,30,15,15,0.5,6023,701,1682,0.417,521,1151,0.453,180,531,0.339,441,625,0.706,2023,2010,11
2632,Miami (OH),2013-14,31,13,18,0.419,6249,722,1664,0.434,576,1168,0.493,146,496,0.294,433,574,0.754,2023,2013,14
2633,LIU,2014-15,30,12,18,0.4,6150,677,1726,0.392,482,1125,0.428,195,601,0.324,473,687,0.689,2022,2014,15
2634,Texas Southern,2011-12,33,15,18,0.455,6650,684,1656,0.413,501,1101,0.455,183,555,0.33,470,746,0.63,2021,2011,12
2635,UTEP,2011-12,32,15,17,0.469,6550,727,1588,0.458,583,1165,0.5,144,423,0.34,423,619,0.683,2021,2011,12
2636,Xavier,2012-13,31,17,14,0.548,6250,722,1582,0.456,582,1182,0.492,140,400,0.35,437,655,0.667,2021,2012,13
2637,Denver,2015-16,31,16,15,0.516,6201,689,1449,0.476,454,836,0.543,235,613,0.383,408,530,0.77,2021,2015,16
2638,Oregon State,2016-17,32,5,27,0.156,6425,721,1686,0.428,518,1100,0.471,203,586,0.346,376,569,0.661,2021,2016,17
2639,Nicholls State,2012-13,30,9,21,0.3,6080,713,1627,0.438,554,1106,0.501,159,521,0.305,435,651,0.668,2020,2012,13
2640,Howard,2013-14,33,8,25,0.242,6676,639,1690,0.378,464,1171,0.396,175,519,0.337,567,835,0.679,2020,2013,14
2641,Pepperdine,2014-15,32,18,14,0.563,6401,704,1666,0.423,559,1203,0.465,145,463,0.313,467,630,0.741,2020,2014,15
2642,UIC,2015-16,30,5,25,0.167,6100,697,1796,0.388,564,1356,0.416,133,440,0.302,492,795,0.619,2019,2015,16
2643,Portland,2011-12,31,7,24,0.226,6226,723,1691,0.428,561,1184,0.474,162,507,0.32,410,571,0.718,2018,2011,12
2644,UNC Wilmington,2013-14,32,9,23,0.281,6500,741,1841,0.402,602,1332,0.452,139,509,0.273,397,606,0.655,2018,2013,14
2645,Bryant,2015-16,31,8,23,0.258,6250,755,1798,0.42,557,1183,0.471,198,615,0.322,310,482,0.643,2018,2015,16
2646,Longwood,2016-17,30,6,24,0.2,6000,738,1660,0.445,552,1092,0.505,186,568,0.327,356,487,0.731,2018,2016,17
2647,Kennesaw State,2010-11,31,8,23,0.258,6325,720,1731,0.416,544,1151,0.473,176,580,0.303,401,618,0.649,2017,2010,11
2648,Prairie View,2011-12,32,14,18,0.438,6400,755,1922,0.393,589,1390,0.424,166,532,0.312,340,629,0.541,2016,2011,12
2649,Kennesaw State,2013-14,31,6,25,0.194,6200,708,1676,0.422,516,1117,0.462,192,559,0.343,408,628,0.65,2016,2013,14
2650,Charleston,2013-14,32,14,18,0.438,6499,709,1719,0.412,500,1106,0.452,209,613,0.341,389,593,0.656,2016,2013,14
2651,Kansas State,2014-15,32,15,17,0.469,6425,690,1593,0.433,549,1172,0.468,141,421,0.335,495,732,0.676,2016,2014,15
2652,Florida A&M,2012-13,31,8,23,0.258,6300,732,1849,0.396,561,1289,0.435,171,560,0.305,380,606,0.627,2015,2012,13
2653,Fordham,2014-15,31,10,21,0.323,6225,711,1713,0.415,524,1100,0.476,187,613,0.305,406,559,0.726,2015,2014,15
2654,Jacksonville St.,2013-14,31,10,21,0.323,6198,685,1633,0.419,510,1092,0.467,175,541,0.323,469,695,0.675,2014,2013,14
2655,Alcorn State,2015-16,30,15,15,0.5,6152,691,1692,0.408,517,1126,0.459,174,566,0.307,458,676,0.678,2014,2015,16
2656,Albany (NY),2010-11,32,16,16,0.5,6525,724,1707,0.424,486,1077,0.451,238,630,0.378,327,507,0.645,2013,2010,11
2657,UNC Wilmington,2011-12,31,10,21,0.323,6200,723,1740,0.416,550,1210,0.455,173,530,0.326,394,580,0.679,2013,2011,12
2658,Ark-Pine Bluff,2011-12,33,11,22,0.333,6625,705,1707,0.413,560,1223,0.458,145,484,0.3,458,719,0.637,2013,2011,12
2659,Western Ill.,2016-17,28,8,20,0.286,5725,711,1633,0.435,457,979,0.467,254,654,0.388,336,475,0.707,2012,2016,17
2660,Harvard,2016-17,28,18,10,0.643,5600,699,1564,0.447,470,919,0.511,229,645,0.355,385,518,0.743,2012,2016,17
2661,Western Ill.,2017-18,28,12,16,0.429,5675,749,1607,0.466,561,1080,0.519,188,527,0.357,326,456,0.715,2012,2017,18
2662,St. Peter's,2018-19,32,10,22,0.313,6525,707,1639,0.431,523,1072,0.488,184,567,0.325,414,570,0.726,2012,2018,19
2663,Prairie View,2010-11,32,10,22,0.313,6475,733,1920,0.382,531,1249,0.425,202,671,0.301,343,596,0.576,2011,2010,11
2664,George Washington,2010-11,31,17,14,0.548,6225,712,1716,0.415,530,1175,0.451,182,541,0.336,405,646,0.627,2011,2010,11
2665,Southern Utah,2014-15,29,10,19,0.345,5849,700,1537,0.455,490,1000,0.49,210,537,0.391,401,599,0.669,2011,2014,15
2666,Charlotte,2011-12,30,13,17,0.433,6050,693,1683,0.412,501,1093,0.458,192,590,0.325,432,656,0.659,2010,2011,12
2667,Bowling Green,2012-13,32,13,19,0.406,6502,753,1795,0.419,595,1279,0.465,158,516,0.306,346,484,0.715,2010,2012,13
2668,Weber State,2014-15,30,13,17,0.433,6050,641,1518,0.422,424,911,0.465,217,607,0.357,511,683,0.748,2010,2014,15
2669,Monmouth,2012-13,31,10,21,0.323,6200,715,1800,0.397,546,1255,0.435,169,545,0.31,410,581,0.706,2009,2012,13
2670,Abilene Christ.,2016-17,29,13,16,0.448,5900,721,1555,0.464,514,1005,0.511,207,550,0.376,360,543,0.663,2009,2016,17
2671,UT-Martin,2012-13,30,9,21,0.3,6101,682,1733,0.394,513,1227,0.418,169,506,0.334,475,640,0.742,2008,2012,13
2672,Bowling Green,2013-14,32,12,20,0.375,6451,743,1745,0.426,623,1328,0.469,120,417,0.288,401,630,0.637,2007,2013,14
2673,UCF,2017-18,32,19,13,0.594,6425,690,1627,0.424,513,1089,0.471,177,538,0.329,450,702,0.641,2007,2017,18
2674,Furman,2011-12,31,15,16,0.484,6200,681,1646,0.414,471,1023,0.46,210,623,0.337,434,608,0.714,2006,2011,12
2675,San Diego,2014-15,31,15,16,0.484,6250,690,1636,0.422,498,1074,0.464,192,562,0.342,434,632,0.687,2006,2014,15
2676,Milwaukee,2012-13,32,8,24,0.25,6500,675,1741,0.388,452,1033,0.438,223,708,0.315,432,632,0.684,2005,2012,13
2677,UCSB,2012-13,31,11,20,0.355,6277,703,1676,0.419,456,962,0.474,247,714,0.346,350,506,0.692,2003,2012,13
2678,St. Francis (NY),2010-11,30,15,15,0.5,6000,673,1685,0.399,464,1012,0.458,209,673,0.311,447,675,0.662,2002,2010,11
2679,Brown,2010-11,28,11,17,0.393,5625,688,1567,0.439,479,957,0.501,209,610,0.343,417,558,0.747,2002,2010,11
2680,Ga. Southern,2011-12,30,15,15,0.5,6075,749,1608,0.466,586,1144,0.512,163,464,0.351,341,513,0.665,2002,2011,12
2681,Tulane,2011-12,31,15,16,0.484,6250,693,1641,0.422,509,1095,0.465,184,546,0.337,432,653,0.662,2002,2011,12
2682,Alcorn State,2011-12,32,10,22,0.313,6450,712,1710,0.416,568,1257,0.452,144,453,0.318,434,624,0.696,2002,2011,12
2683,Vanderbilt,2013-14,31,15,16,0.484,6249,689,1598,0.431,498,999,0.498,191,599,0.319,433,658,0.658,2002,2013,14
2684,Bryant,2010-11,30,9,21,0.3,6075,704,1683,0.418,461,1010,0.456,243,673,0.361,350,537,0.652,2001,2010,11
2685,Clemson,2011-12,31,16,15,0.516,6250,736,1701,0.433,565,1169,0.483,171,532,0.321,358,534,0.67,2001,2011,12
2686,SC St.,2011-12,31,5,26,0.161,6250,721,1827,0.395,579,1329,0.436,142,498,0.285,417,641,0.651,2001,2011,12
2687,Lamar,2013-14,30,4,26,0.133,6001,711,1628,0.437,614,1313,0.468,97,315,0.308,482,648,0.744,2001,2013,14
2688,Harvard,2015-16,30,14,16,0.467,6025,734,1648,0.445,514,1079,0.476,220,569,0.387,313,526,0.595,2001,2015,16
2689,Virginia,2011-12,32,22,10,0.688,6425,721,1576,0.457,566,1107,0.511,155,469,0.33,403,558,0.722,2000,2011,12
2690,Grambling,2010-11,33,12,21,0.364,6701,699,1838,0.38,533,1282,0.416,166,556,0.299,434,707,0.614,1998,2010,11
2691,UMKC,2011-12,31,10,21,0.323,6249,699,1621,0.431,443,942,0.47,256,679,0.377,344,495,0.695,1998,2011,12
2692,Old Dominion,2016-17,31,19,12,0.613,6250,727,1765,0.412,570,1280,0.445,157,485,0.324,387,602,0.643,1998,2016,17
2693,Charlotte,2010-11,30,10,20,0.333,6250,674,1629,0.414,472,1023,0.461,202,606,0.333,447,613,0.729,1997,2010,11
2694,Drake,2010-11,31,13,18,0.419,6225,687,1608,0.427,484,1035,0.468,203,573,0.354,420,613,0.685,1997,2010,11
2695,Fordham,2012-13,31,7,24,0.226,6200,718,1785,0.402,550,1245,0.442,168,540,0.311,393,583,0.674,1997,2012,13
2696,Delaware State,2012-13,33,15,18,0.455,6725,709,1731,0.41,526,1110,0.474,183,621,0.295,396,574,0.69,1997,2012,13
2697,Tennessee State,2017-18,30,15,15,0.5,6100,669,1574,0.425,446,910,0.49,223,664,0.336,436,590,0.739,1997,2017,18
2698,Troy,2011-12,28,10,18,0.357,5651,721,1758,0.41,471,1034,0.456,250,724,0.345,304,450,0.676,1996,2011,12
2699,Md.-East. Shore,2013-14,30,6,24,0.2,5997,656,1637,0.401,476,1079,0.441,180,558,0.323,504,699,0.721,1996,2013,14
2700,George Mason,2014-15,31,9,22,0.29,6274,708,1663,0.426,578,1257,0.46,130,406,0.32,450,676,0.666,1996,2014,15
,,,,,,,,School,School,School,School,School,School,School,School,School,School,School,School,School,,
,Schl,Season,G,W,L,W-L%,MP,FG,FGA,FG%,2P,2PA,2P%,3P,3PA,3P%,FT,FTA,FT%,PTS,Season,
2701,Pacific,2014-15,31,12,19,0.387,6275,681,1633,0.417,479,1049,0.457,202,584,0.346,432,667,0.648,1996,2014,15
2702,Loyola (IL),2012-13,31,15,16,0.484,6225,708,1586,0.446,524,1081,0.485,184,505,0.364,395,550,0.718,1995,2012,13
2703,Lafayette,2016-17,30,9,21,0.3,6025,712,1655,0.43,491,993,0.494,221,662,0.334,350,492,0.711,1995,2016,17
2704,Alcorn State,2018-19,31,10,21,0.323,6224,709,1721,0.412,498,1075,0.463,211,646,0.327,366,543,0.674,1995,2018,19
2705,ETSU,2012-13,32,10,22,0.313,6426,708,1751,0.404,500,1114,0.449,208,637,0.327,370,554,0.668,1994,2012,13
2706,Tx-Rio Grande,2011-12,32,11,21,0.344,6400,677,1631,0.415,447,1000,0.447,230,631,0.365,409,580,0.705,1993,2011,12
2707,Georgia Tech,2012-13,31,16,15,0.516,6225,751,1791,0.419,578,1247,0.464,173,544,0.318,318,501,0.635,1993,2012,13
2708,Tx-Rio Grande,2015-16,30,8,22,0.267,6001,716,1712,0.418,504,1079,0.467,212,633,0.335,349,520,0.671,1993,2015,16
2709,East Carolina,2017-18,30,10,20,0.333,6075,741,1723,0.43,559,1126,0.496,182,597,0.305,329,494,0.666,1993,2017,18
2710,Northern Ill.,2013-14,32,15,17,0.469,6527,645,1651,0.391,508,1157,0.439,137,494,0.277,565,826,0.684,1992,2013,14
2711,Cornell,2015-16,28,10,18,0.357,5650,703,1674,0.42,470,992,0.474,233,682,0.342,353,542,0.651,1992,2015,16
2712,Dartmouth,2015-16,28,10,18,0.357,5650,700,1606,0.436,544,1148,0.474,156,458,0.341,436,603,0.723,1992,2015,16
2713,Md.-East. Shore,2017-18,32,7,25,0.219,6400,710,1844,0.385,504,1119,0.45,206,725,0.284,366,542,0.675,1992,2017,18
2714,LSU,2010-11,32,11,21,0.344,6450,692,1731,0.4,517,1170,0.442,175,561,0.312,432,650,0.665,1991,2010,11
2715,Yale,2011-12,29,19,10,0.655,5825,678,1571,0.432,502,1062,0.473,176,509,0.346,459,646,0.711,1991,2011,12
2716,Vanderbilt,2012-13,33,16,17,0.485,6650,681,1671,0.408,424,937,0.453,257,734,0.35,372,586,0.635,1991,2012,13
2717,Cal St Fullerton,2014-15,31,9,22,0.29,6277,698,1695,0.412,531,1172,0.453,167,523,0.319,428,623,0.687,1991,2014,15
2718,Jackson State,2017-18,32,12,20,0.375,6475,714,1921,0.372,476,1197,0.398,238,724,0.329,325,497,0.654,1991,2017,18
2719,Savannah State,2015-16,32,16,16,0.5,6425,667,1685,0.396,463,1038,0.446,204,647,0.315,452,686,0.659,1990,2015,16
2720,Nicholls State,2011-12,30,10,20,0.333,6025,694,1616,0.429,496,991,0.501,198,625,0.317,403,599,0.673,1989,2011,12
2721,Maine,2011-12,29,12,17,0.414,5876,750,1696,0.442,581,1178,0.493,169,518,0.326,320,437,0.732,1989,2011,12
2722,Wright State,2014-15,31,11,20,0.355,6251,715,1619,0.442,521,1048,0.497,194,571,0.34,365,524,0.697,1989,2014,15
2723,UMass,2010-11,30,15,15,0.5,6025,698,1742,0.401,533,1174,0.454,165,568,0.29,427,645,0.662,1988,2010,11
2724,Maine,2012-13,30,11,19,0.367,6000,733,1688,0.434,577,1158,0.498,156,530,0.294,366,559,0.655,1988,2012,13
2725,George Washington,2012-13,30,13,17,0.433,6025,732,1660,0.441,648,1359,0.477,84,301,0.279,440,670,0.657,1988,2012,13
2726,Maine,2018-19,32,5,27,0.156,6550,747,1728,0.432,546,1081,0.505,201,647,0.311,293,452,0.648,1988,2018,19
2727,Presbyterian,2012-13,32,8,24,0.25,6450,739,1640,0.451,547,1086,0.504,192,554,0.347,317,421,0.753,1987,2012,13
2728,La Salle,2015-16,31,9,22,0.29,6200,690,1707,0.404,431,945,0.456,259,762,0.34,348,520,0.669,1987,2015,16
2729,Stetson,2010-11,31,8,23,0.258,6298,701,1641,0.427,537,1089,0.493,164,552,0.297,420,677,0.62,1986,2010,11
2730,Nicholls State,2013-14,29,14,15,0.483,5851,708,1595,0.444,530,1013,0.523,178,582,0.306,392,619,0.633,1986,2013,14
2731,Delaware,2015-16,30,7,23,0.233,6025,669,1663,0.402,501,1146,0.437,168,517,0.325,480,701,0.685,1986,2015,16
2732,Gardner-Webb,2010-11,32,11,21,0.344,6426,716,1742,0.411,513,1116,0.46,203,626,0.324,350,545,0.642,1985,2010,11
2733,Alcorn State,2013-14,31,12,19,0.387,6323,693,1658,0.418,557,1209,0.461,136,449,0.303,463,708,0.654,1985,2013,14
2734,Pitt,2017-18,32,8,24,0.25,6450,678,1673,0.405,420,878,0.478,258,795,0.325,371,534,0.695,1985,2017,18
2735,Central Ark.,2010-11,29,5,24,0.172,5825,690,1657,0.416,525,1130,0.465,165,527,0.313,439,684,0.642,1984,2010,11
2736,Samford,2011-12,30,11,19,0.367,6050,712,1604,0.444,465,865,0.538,247,739,0.334,313,478,0.655,1984,2011,12
2737,Arizona State,2010-11,31,12,19,0.387,6225,719,1674,0.43,479,990,0.484,240,684,0.351,305,486,0.628,1983,2010,11
2738,Cal St Northridge,2017-18,30,6,24,0.2,6075,731,1689,0.433,545,1175,0.464,186,514,0.362,335,473,0.708,1983,2017,18
2739,Columbia,2010-11,28,15,13,0.536,5650,702,1642,0.428,544,1174,0.463,158,468,0.338,420,588,0.714,1982,2010,11
2740,South Dakota,2011-12,28,10,18,0.357,5650,710,1576,0.451,519,1042,0.498,191,534,0.358,371,530,0.7,1982,2011,12
2741,Houston Baptist,2012-13,31,14,17,0.452,6300,712,1720,0.414,571,1279,0.446,141,441,0.32,417,628,0.664,1982,2012,13
2742,UCF,2014-15,30,12,18,0.4,6150,704,1621,0.434,502,1044,0.481,202,577,0.35,371,577,0.643,1981,2014,15
2743,Cal St Bakersfield,2017-18,30,12,18,0.4,6000,697,1670,0.417,512,1057,0.484,185,613,0.302,402,578,0.696,1981,2017,18
2744,Central Mich.,2011-12,32,11,21,0.344,6450,700,1772,0.395,497,1164,0.427,203,608,0.334,377,594,0.635,1980,2011,12
2745,Air Force,2013-14,30,12,18,0.4,6049,679,1561,0.435,463,908,0.51,216,653,0.331,406,588,0.69,1980,2013,14
2746,Delaware State,2015-16,32,7,25,0.219,6450,710,1815,0.391,480,1117,0.43,230,698,0.33,330,536,0.616,1980,2015,16
2747,Marist,2010-11,33,6,27,0.182,6600,662,1734,0.382,455,1069,0.426,207,665,0.311,448,629,0.712,1979,2010,11
2748,Idaho State,2011-12,30,9,21,0.3,6149,695,1652,0.421,502,1090,0.461,193,562,0.343,396,579,0.684,1979,2011,12
2749,Alabama State,2012-13,32,10,22,0.313,6450,734,1800,0.408,566,1243,0.455,168,557,0.302,343,575,0.597,1979,2012,13
2750,Holy Cross,2014-15,30,14,16,0.467,6100,692,1643,0.421,503,1086,0.463,189,557,0.339,406,568,0.715,1979,2014,15
2751,Delaware,2014-15,30,10,20,0.333,6075,675,1646,0.41,476,1070,0.445,199,576,0.345,430,627,0.686,1979,2014,15
2752,Presbyterian,2014-15,32,10,22,0.313,6403,741,1656,0.447,605,1231,0.491,136,425,0.32,360,546,0.659,1978,2014,15
2753,Incarnate Word,2017-18,28,7,21,0.25,5600,671,1566,0.428,505,1073,0.471,166,493,0.337,470,630,0.746,1978,2017,18
2754,Fla. Atlantic,2011-12,30,11,19,0.367,6150,718,1738,0.413,510,1125,0.453,208,613,0.339,333,502,0.663,1977,2011,12
2755,Penn State,2011-12,32,12,20,0.375,6400,695,1770,0.393,494,1123,0.44,201,647,0.311,386,563,0.686,1977,2011,12
2756,Bucknell,2013-14,30,16,14,0.533,6000,698,1627,0.429,502,1125,0.446,196,502,0.39,385,516,0.746,1977,2013,14
2757,Miss. St.,2014-15,32,13,19,0.406,6401,669,1557,0.43,536,1123,0.477,133,434,0.306,506,727,0.696,1977,2014,15
2758,Ark-Pine Bluff,2016-17,32,7,25,0.219,6522,695,1725,0.403,487,1104,0.441,208,621,0.335,379,581,0.652,1977,2016,17
2759,Abilene Christ.,2014-15,31,10,21,0.323,6200,695,1684,0.413,463,1074,0.431,232,610,0.38,354,487,0.727,1976,2014,15
2760,Alabama A&M,2015-16,29,11,18,0.379,5875,681,1632,0.417,506,1033,0.49,175,599,0.292,439,642,0.684,1976,2015,16
2761,UNC Wilmington,2010-11,31,13,18,0.419,6325,714,1646,0.434,493,1047,0.471,221,599,0.369,326,473,0.689,1975,2010,11
2762,Drexel,2010-11,31,21,10,0.677,6225,719,1696,0.424,602,1318,0.457,117,378,0.31,420,683,0.615,1975,2010,11
2763,Siena,2011-12,31,14,17,0.452,6225,718,1692,0.424,572,1216,0.47,146,476,0.307,393,577,0.681,1975,2011,12
2764,Little Rock,2011-12,31,15,16,0.484,6300,672,1655,0.406,511,1163,0.439,161,492,0.327,469,672,0.698,1974,2011,12
2765,San Jose State,2017-18,30,4,26,0.133,6050,705,1618,0.436,527,1133,0.465,178,485,0.367,386,558,0.692,1974,2017,18
2766,Wagner,2018-19,30,13,17,0.433,6023,655,1696,0.386,419,923,0.454,236,773,0.305,428,575,0.744,1974,2018,19
2767,Jackson State,2018-19,32,13,19,0.406,6424,717,1774,0.404,562,1220,0.461,155,554,0.28,385,607,0.634,1974,2018,19
2768,Winthrop,2010-11,30,13,17,0.433,6125,719,1732,0.415,593,1322,0.449,126,410,0.307,409,636,0.643,1973,2010,11
2769,TCU,2013-14,31,9,22,0.29,6201,654,1623,0.403,508,1169,0.435,146,454,0.322,519,709,0.732,1973,2013,14
2770,Tulane,2014-15,31,15,16,0.484,6325,699,1700,0.411,500,1090,0.459,199,610,0.326,376,579,0.649,1973,2014,15
2771,Holy Cross,2017-18,31,12,19,0.387,6250,724,1569,0.461,521,946,0.551,203,623,0.326,321,465,0.69,1972,2017,18
2772,Northern Ill.,2014-15,30,14,16,0.467,6075,661,1543,0.428,512,1073,0.477,149,470,0.317,500,735,0.68,1971,2014,15
2773,Georgia State,2015-16,30,16,14,0.533,6100,705,1597,0.441,556,1161,0.479,149,436,0.342,412,598,0.689,1971,2015,16
2774,Fla. Gulf Coast,2010-11,30,10,20,0.333,6075,667,1662,0.401,492,1131,0.435,175,531,0.33,461,708,0.651,1970,2010,11
2775,Stephen F. Austin,2011-12,32,20,12,0.625,6450,724,1620,0.447,613,1233,0.497,111,387,0.287,411,650,0.632,1970,2011,12
2776,UMBC,2012-13,31,8,23,0.258,6301,718,1763,0.407,512,1152,0.444,206,611,0.337,328,520,0.631,1970,2012,13
2777,South Florida,2014-15,32,9,23,0.281,6475,745,1720,0.433,609,1272,0.479,136,448,0.304,344,556,0.619,1970,2014,15
2778,Chicago State,2018-19,32,3,29,0.094,6396,718,1752,0.41,577,1281,0.45,141,471,0.299,393,581,0.676,1970,2018,19
2779,South Alabama,2010-11,28,12,16,0.429,5650,684,1618,0.423,526,1143,0.46,158,475,0.333,443,666,0.665,1969,2010,11
2780,Quinnipiac,2015-16,30,9,21,0.3,6075,698,1897,0.368,469,1226,0.383,229,671,0.341,344,532,0.647,1969,2015,16
2781,UMBC,2013-14,30,9,21,0.3,6152,669,1667,0.401,496,1097,0.452,173,570,0.304,457,698,0.655,1968,2013,14
2782,Savannah State,2013-14,32,13,19,0.406,6475,693,1653,0.419,536,1151,0.466,157,502,0.313,425,652,0.652,1968,2013,14
2783,Southern Ill.,2014-15,33,12,21,0.364,6601,681,1626,0.419,543,1208,0.45,138,418,0.33,468,667,0.702,1968,2014,15
2784,Ball State,2013-14,30,5,25,0.167,6125,651,1601,0.407,455,976,0.466,196,625,0.314,469,679,0.691,1967,2013,14
2785,Niagara,2010-11,32,9,23,0.281,6400,663,1781,0.372,489,1149,0.426,174,632,0.275,466,706,0.66,1966,2010,11
2786,Missouri State,2012-13,33,11,22,0.333,6650,698,1721,0.406,519,1119,0.464,179,602,0.297,391,584,0.67,1966,2012,13
2787,Seattle,2012-13,30,8,22,0.267,6075,734,1750,0.419,553,1193,0.464,181,557,0.325,317,507,0.625,1966,2012,13
2788,St. Peter's,2015-16,30,14,16,0.467,6050,700,1660,0.422,517,1100,0.47,183,560,0.327,383,582,0.658,1966,2015,16
2789,Canisius,2011-12,30,5,25,0.167,6050,704,1731,0.407,513,1151,0.446,191,580,0.329,366,503,0.728,1965,2011,12
2790,Southeastern LA,2012-13,31,13,18,0.419,6225,690,1686,0.409,507,1174,0.432,183,512,0.357,402,607,0.662,1965,2012,13
2791,SC St.,2014-15,33,11,22,0.333,6625,706,1846,0.382,522,1238,0.422,184,608,0.303,369,612,0.603,1965,2014,15
2792,Western Caro.,2016-17,32,9,23,0.281,6400,719,1843,0.39,537,1251,0.429,182,592,0.307,345,528,0.653,1965,2016,17
2793,Southern Ill.,2012-13,31,14,17,0.452,6224,733,1645,0.446,594,1211,0.491,139,434,0.32,359,559,0.642,1964,2012,13
2794,Northwestern,2013-14,33,14,19,0.424,6650,665,1679,0.396,448,971,0.461,217,708,0.306,417,596,0.7,1964,2013,14
2795,Milwaukee,2014-15,30,14,16,0.467,5999,659,1564,0.421,448,940,0.477,211,624,0.338,434,589,0.737,1963,2014,15
2796,Tx AM-CC,2017-18,29,11,18,0.379,5850,691,1589,0.435,542,1152,0.47,149,437,0.341,432,603,0.716,1963,2017,18
2797,Georgia Tech,2014-15,31,12,19,0.387,6302,734,1800,0.408,603,1309,0.461,131,491,0.267,363,560,0.648,1962,2014,15
2798,St. Peter's,2013-14,31,14,17,0.452,6251,659,1618,0.407,496,1102,0.45,163,516,0.316,480,682,0.704,1961,2013,14
2799,Ball State,2014-15,30,7,23,0.233,6128,669,1580,0.423,435,896,0.485,234,684,0.342,389,561,0.693,1961,2014,15
2800,American,2017-18,30,6,24,0.2,6025,698,1615,0.432,459,906,0.507,239,709,0.337,326,491,0.664,1961,2017,18
,,,,,,,,School,School,School,School,School,School,School,School,School,School,School,School,School,,
,Schl,Season,G,W,L,W-L%,MP,FG,FGA,FG%,2P,2PA,2P%,3P,3PA,3P%,FT,FTA,FT%,PTS,Season,
2801,Radford,2011-12,32,6,26,0.188,6400,699,1819,0.384,497,1160,0.428,202,659,0.307,359,564,0.637,1959,2011,12
2802,James Madison,2013-14,31,11,20,0.355,6226,647,1582,0.409,496,1029,0.482,151,553,0.273,514,750,0.685,1959,2013,14
2803,Boston College,2015-16,32,7,25,0.219,6427,717,1752,0.409,487,1044,0.466,230,708,0.325,295,453,0.651,1959,2015,16
2804,Drexel,2015-16,31,6,25,0.194,6225,677,1721,0.393,507,1204,0.421,170,517,0.329,434,634,0.685,1958,2015,16
2805,St. Francis (PA),2010-11,30,9,21,0.3,6029,684,1588,0.431,514,1077,0.477,170,511,0.333,419,576,0.727,1957,2010,11
2806,Alabama A&M,2012-13,31,11,20,0.355,6275,696,1746,0.399,541,1218,0.444,155,528,0.294,410,651,0.63,1957,2012,13
2807,Samford,2012-13,32,11,21,0.344,6525,711,1601,0.444,508,1039,0.489,203,562,0.361,332,502,0.661,1957,2012,13
2808,Ball State,2012-13,30,15,15,0.5,6000,656,1542,0.425,479,1000,0.479,177,542,0.327,468,718,0.652,1957,2012,13
2809,Loyola (MD),2013-14,30,11,19,0.367,6077,680,1642,0.414,535,1190,0.45,145,452,0.321,452,678,0.667,1957,2013,14
2810,Ark-Pine Bluff,2013-14,31,13,18,0.419,6202,659,1605,0.411,466,1043,0.447,193,562,0.343,446,675,0.661,1957,2013,14
2811,Marist,2014-15,32,7,25,0.219,6400,649,1629,0.398,423,912,0.464,226,717,0.315,433,619,0.7,1957,2014,15
2812,Texas A&M,2011-12,32,14,18,0.438,6425,732,1695,0.432,570,1204,0.473,162,491,0.33,330,502,0.657,1956,2011,12
2813,Fairl. Dickinson,2014-15,29,8,21,0.276,5877,681,1658,0.411,473,1030,0.459,208,628,0.331,386,557,0.693,1956,2014,15
2814,Delaware State,2018-19,31,6,25,0.194,6200,695,1963,0.354,461,1174,0.393,234,789,0.297,332,489,0.679,1956,2018,19
2815,Columbia,2011-12,30,15,15,0.5,6050,683,1586,0.431,472,1021,0.462,211,565,0.373,378,509,0.743,1955,2011,12
2816,Bradley,2011-12,32,7,25,0.219,6401,689,1720,0.401,538,1217,0.442,151,503,0.3,426,625,0.682,1955,2011,12
2817,Furman,2013-14,30,9,21,0.3,6026,680,1540,0.442,516,1048,0.492,164,492,0.333,431,633,0.681,1955,2013,14
2818,Miami (OH),2012-13,31,9,22,0.29,6225,687,1598,0.43,509,1061,0.48,178,537,0.331,402,591,0.68,1954,2012,13
2819,VMI,2017-18,30,9,21,0.3,6000,688,1729,0.398,463,1025,0.452,225,704,0.32,353,477,0.74,1954,2017,18
2820,Saint Louis,2010-11,31,12,19,0.387,6200,715,1638,0.437,545,1117,0.488,170,521,0.326,353,538,0.656,1953,2010,11
2821,Southern Ill.,2010-11,32,13,19,0.406,6450,691,1618,0.427,550,1179,0.466,141,439,0.321,430,621,0.692,1953,2010,11
2822,Drexel,2012-13,31,13,18,0.419,6325,680,1651,0.412,499,1111,0.449,181,540,0.335,412,553,0.745,1953,2012,13
2823,Navy,2014-15,32,13,19,0.406,6400,719,1637,0.439,549,1119,0.491,170,518,0.328,344,513,0.671,1952,2014,15
2824,Southern Miss,2016-17,31,9,22,0.29,6302,690,1728,0.399,490,1073,0.457,200,655,0.305,372,526,0.707,1952,2016,17
2825,Stony Brook,2010-11,32,15,17,0.469,6550,679,1777,0.382,458,1137,0.403,221,640,0.345,372,565,0.658,1951,2010,11
2826,Delaware,2010-11,31,14,17,0.452,6250,663,1593,0.416,481,1070,0.45,182,523,0.348,443,641,0.691,1951,2010,11
2827,Jacksonville,2011-12,30,8,22,0.267,6050,706,1688,0.418,555,1214,0.457,151,474,0.319,388,591,0.657,1951,2011,12
2828,Portland,2012-13,32,11,21,0.344,6427,701,1709,0.41,560,1261,0.444,141,448,0.315,408,603,0.677,1951,2012,13
2829,Georgia,2011-12,32,15,17,0.469,6475,692,1751,0.395,490,1104,0.444,202,647,0.312,364,530,0.687,1950,2011,12
2830,UMKC,2012-13,32,8,24,0.25,6399,703,1667,0.422,504,1082,0.466,199,585,0.34,345,512,0.674,1950,2012,13
2831,Virginia Tech,2013-14,31,9,22,0.29,6275,665,1639,0.406,450,1043,0.431,215,596,0.361,405,625,0.648,1950,2013,14
2832,Holy Cross,2010-11,29,8,21,0.276,5850,713,1618,0.441,565,1164,0.485,148,454,0.326,375,577,0.65,1949,2010,11
2833,Texas Tech,2014-15,32,13,19,0.406,6450,652,1610,0.405,483,1086,0.445,169,524,0.323,476,742,0.642,1949,2014,15
2834,Pacific,2015-16,28,8,20,0.286,5700,685,1559,0.439,495,983,0.504,190,576,0.33,388,575,0.675,1948,2015,16
2835,Princeton,2018-19,28,16,12,0.571,5676,685,1666,0.411,478,987,0.484,207,679,0.305,371,502,0.739,1948,2018,19
2836,Colgate,2010-11,30,7,23,0.233,6073,683,1631,0.419,519,1141,0.455,164,490,0.335,417,611,0.682,1947,2010,11
2837,Old Dominion,2012-13,30,5,25,0.167,6025,707,1727,0.409,569,1221,0.466,138,506,0.273,395,598,0.661,1947,2012,13
2838,Penn,2012-13,31,9,22,0.29,6225,689,1620,0.425,520,1127,0.461,169,493,0.343,400,558,0.717,1947,2012,13
2839,Cleveland State,2015-16,32,9,23,0.281,6425,704,1746,0.403,530,1209,0.438,174,537,0.324,365,538,0.678,1947,2015,16
2840,Georgia,2012-13,32,15,17,0.469,6499,636,1557,0.408,448,1031,0.435,188,526,0.357,486,700,0.694,1946,2012,13
2841,Troy,2014-15,29,10,19,0.345,5849,674,1566,0.43,482,989,0.487,192,577,0.333,406,612,0.663,1946,2014,15
2842,South Florida,2016-17,30,7,23,0.233,6024,716,1684,0.425,542,1181,0.459,174,503,0.346,339,516,0.657,1945,2016,17
2843,Coppin State,2017-18,32,5,27,0.156,6525,657,1824,0.36,392,955,0.41,265,869,0.305,366,497,0.736,1945,2017,18
2844,Southern Ill.,2011-12,31,8,23,0.258,6250,709,1711,0.414,574,1233,0.466,135,478,0.282,391,611,0.64,1944,2011,12
2845,Clemson,2014-15,31,16,15,0.516,6250,689,1685,0.409,518,1113,0.465,171,572,0.299,395,579,0.682,1944,2014,15
2846,SE Missouri St,2015-16,29,5,24,0.172,5824,699,1710,0.409,545,1197,0.455,154,513,0.3,392,612,0.641,1944,2015,16
2847,UIC,2010-11,31,7,24,0.226,6275,723,1703,0.425,577,1236,0.467,146,467,0.313,351,526,0.667,1943,2010,11
2848,Tx AM-CC,2010-11,31,10,21,0.323,6250,684,1583,0.432,539,1096,0.492,145,487,0.298,430,668,0.644,1943,2010,11
2849,UT-Martin,2011-12,31,4,27,0.129,6275,701,1698,0.413,576,1261,0.457,125,437,0.286,416,592,0.703,1943,2011,12
2850,Coastal Caro.,2012-13,29,14,15,0.483,5825,714,1626,0.439,584,1207,0.484,130,419,0.31,385,587,0.656,1943,2012,13
2851,Northwestern,2012-13,32,13,19,0.406,6425,661,1648,0.401,419,938,0.447,242,710,0.341,379,558,0.679,1943,2012,13
2852,Auburn,2011-12,31,15,16,0.484,6275,696,1669,0.417,540,1152,0.469,156,517,0.302,394,608,0.648,1942,2011,12
2853,Northeastern,2011-12,31,14,17,0.452,6250,676,1579,0.428,507,1094,0.463,169,485,0.348,420,598,0.702,1941,2011,12
2854,Jackson State,2014-15,32,11,21,0.344,6450,701,1812,0.387,548,1254,0.437,153,558,0.274,386,597,0.647,1941,2014,15
2855,Mt. St. Mary's,2010-11,32,11,21,0.344,6450,689,1645,0.419,539,1183,0.456,150,462,0.325,412,606,0.68,1940,2010,11
2856,Miss. St.,2012-13,32,10,22,0.313,6450,670,1672,0.401,519,1141,0.455,151,531,0.284,449,683,0.657,1940,2012,13
2857,Columbia,2016-17,27,11,16,0.407,5450,700,1603,0.437,489,1019,0.48,211,584,0.361,329,465,0.708,1940,2016,17
2858,Jacksonville St.,2014-15,31,12,19,0.387,6275,647,1698,0.381,468,1100,0.425,179,598,0.299,466,651,0.716,1939,2014,15
2859,San Jose State,2013-14,31,7,24,0.226,6277,631,1686,0.374,366,889,0.412,265,797,0.332,411,569,0.722,1938,2013,14
2860,American,2014-15,33,17,16,0.515,6695,683,1479,0.462,470,908,0.518,213,571,0.373,359,509,0.705,1938,2014,15
2861,Alabama A&M,2018-19,32,5,27,0.156,6476,736,1809,0.407,554,1231,0.45,182,578,0.315,284,453,0.627,1938,2018,19
2862,Idaho State,2014-15,30,7,23,0.233,6025,699,1588,0.44,551,1168,0.472,148,420,0.352,391,601,0.651,1937,2014,15
2863,Austin Peay,2014-15,30,8,22,0.267,6001,663,1667,0.398,508,1154,0.44,155,513,0.302,456,685,0.666,1937,2014,15
2864,Hampton,2012-13,31,14,17,0.452,6301,678,1731,0.392,543,1218,0.446,135,513,0.263,445,668,0.666,1936,2012,13
2865,Alabama A&M,2013-14,30,14,16,0.467,6075,656,1601,0.41,474,1040,0.456,182,561,0.324,442,674,0.656,1936,2013,14
2866,Green Bay,2011-12,30,15,15,0.5,6026,693,1638,0.423,528,1177,0.449,165,461,0.358,384,544,0.706,1935,2011,12
2867,South Alabama,2011-12,29,17,12,0.586,5875,682,1606,0.425,546,1206,0.453,136,400,0.34,435,621,0.7,1935,2011,12
2868,Missouri,2014-15,32,9,23,0.281,6450,683,1694,0.403,487,1098,0.444,196,596,0.329,373,560,0.666,1935,2014,15
2869,Morgan State,2011-12,29,9,20,0.31,5850,676,1574,0.429,531,1102,0.482,145,472,0.307,437,646,0.676,1934,2011,12
2870,Washington St.,2013-14,31,10,21,0.323,6250,654,1633,0.4,420,920,0.457,234,713,0.328,392,596,0.658,1934,2013,14
2871,Charleston,2014-15,33,9,24,0.273,6650,686,1708,0.402,489,1133,0.432,197,575,0.343,365,553,0.66,1934,2014,15
2872,Auburn,2010-11,31,11,20,0.355,6275,675,1695,0.398,527,1230,0.428,148,465,0.318,435,663,0.656,1933,2010,11
2873,Eastern Ill.,2012-13,32,11,21,0.344,6426,691,1582,0.437,499,1034,0.483,192,548,0.35,359,541,0.664,1933,2012,13
2874,Holy Cross,2016-17,32,15,17,0.469,6425,663,1552,0.427,427,867,0.493,236,685,0.345,370,534,0.693,1932,2016,17
2875,William & Mary,2011-12,32,6,26,0.188,6425,662,1632,0.406,444,953,0.466,218,679,0.321,389,547,0.711,1931,2011,12
2876,Savannah State,2012-13,34,19,15,0.559,6900,710,1691,0.42,579,1246,0.465,131,445,0.294,380,615,0.618,1931,2012,13
2877,Citadel,2012-13,30,8,22,0.267,6025,681,1504,0.453,505,1016,0.497,176,488,0.361,393,559,0.703,1931,2012,13
2878,Fordham,2017-18,31,9,22,0.29,6251,692,1680,0.412,465,893,0.521,227,787,0.288,320,452,0.708,1931,2017,18
2879,Cal Poly,2018-19,29,6,23,0.207,5926,706,1715,0.412,481,1028,0.468,225,687,0.328,293,452,0.648,1930,2018,19
2880,Portland State,2012-13,28,8,20,0.286,5625,701,1542,0.455,550,1141,0.482,151,401,0.377,376,506,0.743,1929,2012,13
2881,UMBC,2010-11,30,5,25,0.167,6100,700,1746,0.401,517,1193,0.433,183,553,0.331,345,488,0.707,1928,2010,11
2882,Toledo,2012-13,28,15,13,0.536,5651,661,1541,0.429,495,1046,0.473,166,495,0.335,440,578,0.761,1928,2012,13
2883,Loyola Marymount,2014-15,31,8,23,0.258,6250,678,1622,0.418,518,1170,0.443,160,452,0.354,412,580,0.71,1928,2014,15
2884,Niagara,2014-15,30,8,22,0.267,6051,642,1608,0.399,458,1084,0.423,184,524,0.351,460,662,0.695,1928,2014,15
2885,Penn,2016-17,28,13,15,0.464,5625,710,1603,0.443,476,913,0.521,234,690,0.339,274,417,0.657,1928,2016,17
2886,Tx-Rio Grande,2014-15,31,10,21,0.323,6200,678,1610,0.421,548,1177,0.466,130,433,0.3,441,652,0.676,1927,2014,15
2887,Florida A&M,2018-19,31,12,19,0.387,6219,719,1640,0.438,539,1151,0.468,180,489,0.368,309,503,0.614,1927,2018,19
2888,Stephen F. Austin,2010-11,29,18,11,0.621,5850,703,1536,0.458,591,1176,0.503,112,360,0.311,408,566,0.721,1926,2010,11
2889,Eastern Mich.,2012-13,34,16,18,0.471,6825,702,1751,0.401,537,1251,0.429,165,500,0.33,357,533,0.67,1926,2012,13
2890,Harvard,2014-15,30,22,8,0.733,6098,671,1548,0.433,525,1136,0.462,146,412,0.354,438,609,0.719,1926,2014,15
2891,Citadel,2011-12,30,6,24,0.2,6100,704,1610,0.437,542,1124,0.482,162,486,0.333,355,537,0.661,1925,2011,12
2892,UC-Davis,2011-12,31,5,26,0.161,6200,661,1614,0.41,421,964,0.437,240,650,0.369,362,529,0.684,1924,2011,12
2893,Grambling,2015-16,31,7,24,0.226,6250,658,1606,0.41,506,1050,0.482,152,556,0.273,456,706,0.646,1924,2015,16
2894,Nebraska,2012-13,33,15,18,0.455,6600,708,1741,0.407,543,1204,0.451,165,537,0.307,342,494,0.692,1923,2012,13
2895,Sacred Heart,2010-11,29,11,18,0.379,5850,672,1565,0.429,507,1087,0.466,165,478,0.345,413,588,0.702,1922,2010,11
2896,George Washington,2011-12,31,10,21,0.323,6200,733,1725,0.425,604,1329,0.454,129,396,0.326,326,491,0.664,1921,2011,12
2897,Siena,2012-13,32,8,24,0.25,6450,659,1631,0.404,474,1082,0.438,185,549,0.337,418,622,0.672,1921,2012,13
2898,New Mexico,2014-15,31,15,16,0.484,6274,686,1588,0.432,538,1108,0.486,148,480,0.308,401,609,0.658,1921,2014,15
2899,St. Francis (NY),2016-17,31,4,27,0.129,6250,650,1871,0.347,429,1079,0.398,221,792,0.279,400,616,0.649,1921,2016,17
2900,Kennesaw State,2011-12,31,3,28,0.097,6325,691,1665,0.415,485,1061,0.457,206,604,0.341,332,531,0.625,1920,2011,12
,,,,,,,,School,School,School,School,School,School,School,School,School,School,School,School,School,,
,Schl,Season,G,W,L,W-L%,MP,FG,FGA,FG%,2P,2PA,2P%,3P,3PA,3P%,FT,FTA,FT%,PTS,Season,
2901,Jackson State,2012-13,29,11,18,0.379,5874,647,1659,0.39,466,1079,0.432,181,580,0.312,445,637,0.699,1920,2012,13
2902,Georgia State,2010-11,31,12,19,0.387,6325,707,1676,0.422,528,1164,0.454,179,512,0.35,326,549,0.594,1919,2010,11
2903,Citadel,2014-15,30,11,19,0.367,6050,647,1436,0.451,441,921,0.479,206,515,0.4,419,546,0.767,1919,2014,15
2904,Virginia,2010-11,31,16,15,0.516,6250,668,1611,0.415,442,1028,0.43,226,583,0.388,356,516,0.69,1918,2010,11
2905,Delaware State,2011-12,29,15,14,0.517,5925,694,1596,0.435,514,1081,0.475,180,515,0.35,349,498,0.701,1917,2011,12
2906,Montana State,2014-15,30,7,23,0.233,6001,662,1665,0.398,416,978,0.425,246,687,0.358,347,482,0.72,1917,2014,15
2907,Stetson,2013-14,31,7,24,0.226,6242,683,1628,0.42,524,1087,0.482,159,541,0.294,391,590,0.663,1916,2013,14
2908,St. Francis (PA),2013-14,31,10,21,0.323,6200,675,1649,0.409,455,961,0.473,220,688,0.32,346,539,0.642,1916,2013,14
2909,Presbyterian,2010-11,31,13,18,0.419,6300,679,1530,0.444,461,971,0.475,218,559,0.39,339,466,0.727,1915,2010,11
2910,Ark-Pine Bluff,2014-15,32,12,20,0.375,6426,657,1639,0.401,453,1026,0.442,204,613,0.333,397,584,0.68,1915,2014,15
2911,UC-Davis,2015-16,30,11,19,0.367,6125,697,1608,0.433,533,1145,0.466,164,463,0.354,356,557,0.639,1914,2015,16
2912,St. Joseph's,2014-15,31,13,18,0.419,6300,688,1704,0.404,521,1145,0.455,167,559,0.299,369,600,0.615,1912,2014,15
2913,Saint Louis,2014-15,32,11,21,0.344,6449,652,1587,0.411,480,1059,0.453,172,528,0.326,436,666,0.655,1912,2014,15
2914,Penn,2013-14,28,8,20,0.286,5625,684,1517,0.451,544,1081,0.503,140,436,0.321,403,594,0.678,1911,2013,14
2915,Penn,2015-16,28,11,17,0.393,5652,685,1606,0.427,485,949,0.511,200,657,0.304,341,508,0.671,1911,2015,16
2916,Penn State,2012-13,31,10,21,0.323,6250,661,1672,0.395,505,1145,0.441,156,527,0.296,432,621,0.696,1910,2012,13
2917,SMU,2011-12,32,13,19,0.406,6500,645,1539,0.419,397,811,0.49,248,728,0.341,371,551,0.673,1909,2011,12
2918,SIU Edwardsville,2014-15,28,12,16,0.429,5625,660,1532,0.431,462,1011,0.457,198,521,0.38,391,579,0.675,1909,2014,15
2919,Yale,2010-11,28,15,13,0.536,5700,654,1483,0.441,487,996,0.489,167,487,0.343,433,589,0.735,1908,2010,11
2920,Cal St Northridge,2011-12,28,7,21,0.25,5625,641,1671,0.384,471,1117,0.422,170,554,0.307,456,604,0.755,1908,2011,12
2921,Cal St Bakersfield,2010-11,28,9,19,0.321,5655,657,1661,0.396,476,1115,0.427,181,546,0.332,412,598,0.689,1907,2010,11
2922,Brown,2011-12,31,8,23,0.258,6200,685,1695,0.404,451,1048,0.43,234,647,0.362,303,483,0.627,1907,2011,12
2923,Clemson,2012-13,31,13,18,0.419,6200,697,1643,0.424,540,1147,0.471,157,496,0.317,356,544,0.654,1907,2012,13
2924,Cornell,2010-11,28,10,18,0.357,5625,658,1580,0.416,407,909,0.448,251,671,0.374,339,492,0.689,1906,2010,11
2925,Eastern Mich.,2010-11,31,9,22,0.29,6225,659,1696,0.389,445,1032,0.431,214,664,0.322,374,599,0.624,1906,2010,11
2926,Dartmouth,2013-14,28,12,16,0.429,5624,673,1516,0.444,499,1057,0.472,174,459,0.379,385,561,0.686,1905,2013,14
2927,Texas State,2014-15,31,14,17,0.452,6322,664,1645,0.404,505,1139,0.443,159,506,0.314,418,606,0.69,1905,2014,15
2928,Nebraska,2014-15,31,13,18,0.419,6300,664,1613,0.412,503,1047,0.48,161,566,0.284,416,588,0.707,1905,2014,15
2929,Western Ill.,2015-16,27,10,17,0.37,5400,676,1521,0.444,486,1031,0.471,190,490,0.388,362,502,0.721,1904,2015,16
2930,South Carolina,2011-12,31,10,21,0.323,6225,689,1713,0.402,485,1088,0.446,204,625,0.326,321,458,0.701,1903,2011,12
2931,Texas State,2013-14,31,8,23,0.258,6225,697,1604,0.435,552,1130,0.488,145,474,0.306,364,549,0.663,1903,2013,14
2932,Grambling,2013-14,29,5,24,0.172,5801,647,1576,0.411,468,1022,0.458,179,554,0.323,430,645,0.667,1903,2013,14
2933,Ball State,2011-12,30,15,15,0.5,6000,647,1536,0.421,456,955,0.477,191,581,0.329,416,604,0.689,1901,2011,12
2934,UNC Wilmington,2012-13,30,10,20,0.333,6000,679,1627,0.417,519,1152,0.451,160,475,0.337,381,593,0.642,1899,2012,13
2935,Bethune-Cookman,2014-15,32,11,21,0.344,6401,627,1567,0.4,464,1025,0.453,163,542,0.301,482,672,0.717,1899,2014,15
2936,Morgan State,2014-15,31,7,24,0.226,6225,673,1877,0.359,510,1303,0.391,163,574,0.284,389,622,0.625,1898,2014,15
2937,Rutgers,2014-15,32,10,22,0.313,6401,687,1751,0.392,535,1236,0.433,152,515,0.295,372,570,0.653,1898,2014,15
2938,UMBC,2011-12,30,4,26,0.133,6076,686,1753,0.391,534,1241,0.43,152,512,0.297,373,564,0.661,1897,2011,12
2939,Eastern Ill.,2011-12,29,12,17,0.414,5875,688,1579,0.436,541,1149,0.471,147,430,0.342,373,493,0.757,1896,2011,12
2940,UC-Riverside,2016-17,29,8,21,0.276,5824,689,1671,0.412,516,1118,0.462,173,553,0.313,344,495,0.695,1895,2016,17
2941,Central Ark.,2014-15,29,2,27,0.069,5802,646,1524,0.424,450,968,0.465,196,556,0.353,406,599,0.678,1894,2014,15
2942,Illinois State,2010-11,31,12,19,0.387,6275,680,1599,0.425,527,1106,0.476,153,493,0.31,380,537,0.708,1893,2010,11
2943,Colgate,2011-12,30,8,22,0.267,6050,660,1532,0.431,462,1017,0.454,198,515,0.384,375,544,0.689,1893,2011,12
2944,Mt. St. Mary's,2014-15,30,15,15,0.5,6124,662,1645,0.402,434,954,0.455,228,691,0.33,341,500,0.682,1893,2014,15
2945,Arizona State,2011-12,31,10,21,0.323,6200,654,1439,0.454,473,942,0.502,181,497,0.364,402,594,0.677,1891,2011,12
2946,Presbyterian,2011-12,29,14,15,0.483,5825,661,1425,0.464,490,932,0.526,171,493,0.347,396,563,0.703,1889,2011,12
2947,Pacific,2011-12,30,11,19,0.367,6050,644,1591,0.405,444,967,0.459,200,624,0.321,400,581,0.688,1888,2011,12
2948,Central Conn St,2015-16,29,4,25,0.138,5874,682,1704,0.4,518,1224,0.423,164,480,0.342,360,530,0.679,1888,2015,16
2949,Oregon State,2014-15,31,17,14,0.548,6225,665,1577,0.422,505,1082,0.467,160,495,0.323,397,573,0.693,1887,2014,15
2950,Holy Cross,2011-12,29,15,14,0.517,5800,673,1565,0.43,507,1076,0.471,166,489,0.339,374,519,0.721,1886,2011,12
2951,Chicago State,2011-12,30,4,26,0.133,6022,688,1732,0.397,533,1206,0.442,155,526,0.295,353,541,0.652,1884,2011,12
2952,N.C. A&T,2014-15,32,9,23,0.281,6425,648,1622,0.4,491,1067,0.46,157,555,0.283,431,633,0.681,1884,2014,15
2953,Pepperdine,2012-13,30,12,18,0.4,6100,673,1551,0.434,508,1088,0.467,165,463,0.356,372,529,0.703,1883,2012,13
2954,SC St.,2013-14,30,9,21,0.3,6101,676,1709,0.396,528,1185,0.446,148,524,0.282,383,587,0.652,1883,2013,14
2955,IUPUI,2014-15,31,10,21,0.323,6375,692,1623,0.426,566,1197,0.473,126,426,0.296,373,532,0.701,1883,2014,15
2956,Nicholls State,2014-15,29,10,19,0.345,5850,662,1511,0.438,507,1015,0.5,155,496,0.313,404,645,0.626,1883,2014,15
2957,Bradley,2014-15,33,9,24,0.273,6702,639,1700,0.376,460,1106,0.416,179,594,0.301,425,641,0.663,1882,2014,15
2958,Howard,2011-12,31,10,21,0.323,6225,618,1613,0.383,478,1174,0.407,140,439,0.319,505,744,0.679,1881,2011,12
2959,Samford,2010-11,31,12,19,0.387,6250,627,1464,0.428,352,688,0.512,275,776,0.354,351,520,0.675,1880,2010,11
2960,Ark-Pine Bluff,2012-13,30,16,14,0.533,6028,683,1707,0.4,524,1181,0.444,159,526,0.302,355,563,0.631,1880,2012,13
2961,SIU Edwardsville,2010-11,29,8,21,0.276,5900,668,1584,0.422,471,994,0.474,197,590,0.334,346,517,0.669,1879,2010,11
2962,Southern,2011-12,31,17,14,0.548,6275,659,1607,0.41,514,1145,0.449,145,462,0.314,416,607,0.685,1879,2011,12
2963,Idaho State,2010-11,29,9,20,0.31,5875,646,1560,0.414,513,1129,0.454,133,431,0.309,453,646,0.701,1878,2010,11
2964,Tennessee Tech,2012-13,29,12,17,0.414,5801,650,1527,0.426,473,973,0.486,177,554,0.319,401,566,0.708,1878,2012,13
2965,Sacramento St.,2012-13,29,14,15,0.483,5800,640,1546,0.414,480,1072,0.448,160,474,0.338,436,599,0.728,1876,2012,13
2966,Sacramento St.,2011-12,28,10,18,0.357,5602,663,1470,0.451,511,1022,0.5,152,448,0.339,397,568,0.699,1875,2011,12
2967,Sam Houston St.,2011-12,32,13,19,0.406,6425,657,1580,0.416,508,1079,0.471,149,501,0.297,412,689,0.598,1875,2011,12
2968,UAB,2011-12,31,15,16,0.484,6225,654,1559,0.419,475,1039,0.457,179,520,0.344,388,566,0.686,1875,2011,12
2969,Rice,2012-13,31,5,26,0.161,6226,644,1621,0.397,415,924,0.449,229,697,0.329,358,493,0.726,1875,2012,13
2970,Delaware State,2010-11,30,9,21,0.3,6050,674,1576,0.428,468,982,0.477,206,594,0.347,320,448,0.714,1874,2010,11
2971,Nevada,2014-15,31,9,22,0.29,6225,637,1673,0.381,526,1256,0.419,111,417,0.266,489,703,0.696,1874,2014,15
2972,Hofstra,2012-13,32,7,25,0.219,6450,658,1719,0.383,517,1233,0.419,141,486,0.29,416,664,0.627,1873,2012,13
2973,Prairie View,2015-16,31,7,24,0.226,6200,657,1727,0.38,530,1260,0.421,127,467,0.272,432,630,0.686,1873,2015,16
2974,Alabama A&M,2017-18,31,3,28,0.097,6225,673,1697,0.397,491,1096,0.448,182,601,0.303,345,533,0.647,1873,2017,18
2975,Furman,2012-13,31,7,24,0.226,6201,644,1580,0.408,455,1015,0.448,189,565,0.335,392,568,0.69,1869,2012,13
2976,Arkansas State,2014-15,29,11,18,0.379,5850,664,1631,0.407,495,1117,0.443,169,514,0.329,372,530,0.702,1869,2014,15
2977,Penn,2010-11,28,13,15,0.464,5750,644,1417,0.454,459,916,0.501,185,501,0.369,395,536,0.737,1868,2010,11
2978,Cornell,2014-15,30,13,17,0.433,6050,615,1558,0.395,434,979,0.443,181,579,0.313,457,610,0.749,1868,2014,15
2979,NW St.,2017-18,29,4,25,0.138,5800,692,1678,0.412,567,1230,0.461,125,448,0.279,359,588,0.611,1868,2017,18
2980,Ark-Pine Bluff,2015-16,33,8,25,0.242,6624,674,1722,0.391,472,1056,0.447,202,666,0.303,317,519,0.611,1867,2015,16
2981,Fairl. Dickinson,2010-11,29,5,24,0.172,5900,643,1618,0.397,493,1150,0.429,150,468,0.321,430,637,0.675,1866,2010,11
2982,Georgia Tech,2011-12,31,11,20,0.355,6225,700,1639,0.427,542,1132,0.479,158,507,0.312,308,471,0.654,1866,2011,12
2983,Southern Miss,2015-16,29,8,21,0.276,5900,612,1496,0.409,355,775,0.458,257,721,0.356,385,540,0.713,1866,2015,16
2984,Manhattan,2012-13,32,14,18,0.438,6450,614,1506,0.408,433,968,0.447,181,538,0.336,456,689,0.662,1865,2012,13
2985,Denver,2014-15,30,12,18,0.4,6073,657,1369,0.48,433,780,0.555,224,589,0.38,327,427,0.766,1865,2014,15
2986,Hartford,2012-13,31,17,14,0.548,6199,645,1578,0.409,410,875,0.469,235,703,0.334,338,485,0.697,1863,2012,13
2987,Florida A&M,2015-16,29,8,21,0.276,5950,644,1606,0.401,476,1051,0.453,168,555,0.303,407,691,0.589,1863,2015,16
2988,Manhattan,2010-11,31,6,25,0.194,6250,677,1678,0.403,564,1300,0.434,113,378,0.299,395,565,0.699,1862,2010,11
2989,Lamar,2012-13,31,3,28,0.097,6256,710,1741,0.408,653,1553,0.42,57,188,0.303,385,548,0.703,1862,2012,13
2990,Binghamton,2010-11,31,8,23,0.258,6249,651,1641,0.397,418,982,0.426,233,659,0.354,326,465,0.701,1861,2010,11
2991,Hartford,2011-12,31,9,22,0.29,6300,654,1580,0.414,426,844,0.505,228,736,0.31,324,486,0.667,1860,2011,12
2992,La.-Monroe,2010-11,31,7,24,0.226,6200,669,1606,0.417,511,1114,0.459,158,492,0.321,363,560,0.648,1859,2010,11
2993,Winthrop,2012-13,31,14,17,0.452,6225,647,1555,0.416,467,985,0.474,180,570,0.316,385,560,0.688,1859,2012,13
2994,UTEP,2018-19,29,8,21,0.276,5850,639,1592,0.401,440,972,0.453,199,620,0.321,382,578,0.661,1859,2018,19
2995,Wofford,2012-13,32,13,19,0.406,6400,665,1696,0.392,483,1103,0.438,182,593,0.307,346,477,0.725,1858,2012,13
2996,New Orleans,2013-14,26,11,15,0.423,5200,615,1434,0.429,479,1032,0.464,136,402,0.338,492,722,0.681,1858,2013,14
2997,Hartford,2014-15,30,14,16,0.467,6075,645,1596,0.404,410,874,0.469,235,722,0.325,333,477,0.698,1858,2014,15
2998,Hartford,2010-11,31,11,20,0.355,6325,672,1756,0.383,407,887,0.459,265,869,0.305,248,413,0.6,1857,2010,11
2999,Wright State,2011-12,32,13,19,0.406,6450,625,1569,0.398,436,1019,0.428,189,550,0.344,418,594,0.704,1857,2011,12
3000,Jacksonville St.,2012-13,28,17,11,0.607,5650,637,1433,0.445,478,983,0.486,159,450,0.353,424,625,0.678,1857,2012,13
,,,,,,,,School,School,School,School,School,School,School,School,School,School,School,School,School,,
,Schl,Season,G,W,L,W-L%,MP,FG,FGA,FG%,2P,2PA,2P%,3P,3PA,3P%,FT,FTA,FT%,PTS,Season,
3001,UNC Asheville,2018-19,31,4,27,0.129,6225,655,1627,0.403,432,940,0.46,223,687,0.325,324,437,0.741,1857,2018,19
3002,Chicago State,2014-15,32,8,24,0.25,6425,659,1747,0.377,465,1103,0.422,194,644,0.301,343,514,0.667,1855,2014,15
3003,Northern Iowa,2016-17,30,14,16,0.467,6076,622,1559,0.399,393,857,0.459,229,702,0.326,381,520,0.733,1854,2016,17
3004,Toledo,2010-11,32,4,28,0.125,6450,635,1557,0.408,465,1026,0.453,170,531,0.32,413,658,0.628,1853,2010,11
3005,Rice,2013-14,30,7,23,0.233,6125,637,1582,0.403,400,849,0.471,237,733,0.323,342,527,0.649,1853,2013,14
3006,Bryant,2011-12,30,2,28,0.067,6026,656,1626,0.403,447,936,0.478,209,690,0.303,331,480,0.69,1852,2011,12
3007,Ark-Pine Bluff,2010-11,31,7,24,0.226,6273,627,1610,0.389,436,1054,0.414,191,556,0.344,405,646,0.627,1850,2010,11
3008,Missouri State,2014-15,31,11,20,0.355,6300,654,1612,0.406,496,1100,0.451,158,512,0.309,384,525,0.731,1850,2014,15
3009,Delaware State,2013-14,30,9,21,0.3,6075,646,1529,0.422,490,1044,0.469,156,485,0.322,399,579,0.689,1847,2013,14
3010,Western Ill.,2012-13,31,22,9,0.71,6225,659,1414,0.466,498,1002,0.497,161,412,0.391,366,570,0.642,1845,2012,13
3011,Fairfield,2014-15,31,7,24,0.226,6325,614,1578,0.389,416,964,0.432,198,614,0.322,419,585,0.716,1845,2014,15
3012,Binghamton,2014-15,32,6,26,0.188,6425,633,1598,0.396,462,1044,0.443,171,554,0.309,408,618,0.66,1845,2014,15
3013,American,2016-17,30,8,22,0.267,6025,692,1542,0.449,524,1013,0.517,168,529,0.318,293,474,0.618,1845,2016,17
3014,Texas Tech,2011-12,31,8,23,0.258,6225,644,1470,0.438,502,1072,0.468,142,398,0.357,414,590,0.702,1844,2011,12
3015,Drake,2014-15,31,9,22,0.29,6250,637,1396,0.456,437,906,0.482,200,490,0.408,370,482,0.768,1844,2014,15
3016,Central Mich.,2010-11,31,10,21,0.323,6275,661,1720,0.384,505,1241,0.407,156,479,0.326,363,577,0.629,1841,2010,11
3017,UC-Riverside,2011-12,31,14,17,0.452,6325,684,1669,0.41,554,1247,0.444,130,422,0.308,343,498,0.689,1841,2011,12
3018,App. St.,2014-15,29,12,17,0.414,5800,637,1602,0.398,451,1014,0.445,186,588,0.316,381,537,0.709,1841,2014,15
3019,Dartmouth,2017-18,27,7,20,0.259,5425,651,1454,0.448,451,897,0.503,200,557,0.359,339,475,0.714,1841,2017,18
3020,Alabama State,2011-12,31,12,19,0.387,6326,648,1714,0.378,458,1093,0.419,190,621,0.306,354,606,0.584,1840,2011,12
3021,Binghamton,2013-14,30,7,23,0.233,6076,591,1554,0.38,409,985,0.415,182,569,0.32,476,687,0.693,1840,2013,14
3022,SIU Edwardsville,2015-16,28,6,22,0.214,5650,634,1591,0.398,476,1072,0.444,158,519,0.304,413,587,0.704,1839,2015,16
3023,Alcorn State,2010-11,28,4,24,0.143,5625,614,1664,0.369,498,1305,0.382,116,359,0.323,494,781,0.633,1838,2010,11
3024,Western Ill.,2013-14,30,10,20,0.333,6050,667,1467,0.455,525,1049,0.5,142,418,0.34,362,545,0.664,1838,2013,14
3025,Nicholls State,2010-11,28,14,14,0.5,5651,634,1432,0.443,444,865,0.513,190,567,0.335,378,550,0.687,1836,2010,11
3026,FIU,2011-12,29,8,21,0.276,5875,630,1514,0.416,480,1067,0.45,150,447,0.336,426,588,0.724,1836,2011,12
3027,Presbyterian,2016-17,30,5,25,0.167,6026,667,1618,0.412,486,1095,0.444,181,523,0.346,321,468,0.686,1836,2016,17
3028,Dartmouth,2014-15,29,14,15,0.483,5850,657,1510,0.435,484,1010,0.479,173,500,0.346,348,539,0.646,1835,2014,15
3029,Holy Cross,2012-13,30,12,18,0.4,6025,644,1555,0.414,449,984,0.456,195,571,0.342,351,466,0.753,1834,2012,13
3030,Central Conn St,2014-15,31,5,26,0.161,6225,674,1675,0.402,528,1221,0.432,146,454,0.322,340,479,0.71,1834,2014,15
3031,Cornell,2011-12,28,12,16,0.429,5700,639,1567,0.408,422,931,0.453,217,636,0.341,338,494,0.684,1833,2011,12
3032,Boston College,2011-12,31,9,22,0.29,6275,629,1543,0.408,404,879,0.46,225,664,0.339,350,520,0.673,1833,2011,12
3033,Md.-East. Shore,2018-19,32,7,25,0.219,6425,666,1705,0.391,494,1095,0.451,172,610,0.282,329,489,0.673,1833,2018,19
3034,Manhattan,2018-19,32,11,21,0.344,6425,651,1608,0.405,432,947,0.456,219,661,0.331,312,534,0.584,1833,2018,19
3035,Kennesaw State,2012-13,30,3,27,0.1,6125,644,1609,0.4,492,1107,0.444,152,502,0.303,391,601,0.651,1831,2012,13
3036,UC-Riverside,2012-13,31,6,25,0.194,6226,688,1650,0.417,542,1145,0.473,146,505,0.289,307,527,0.583,1829,2012,13
3037,Jacksonville St.,2010-11,30,5,25,0.167,6075,656,1546,0.424,482,1073,0.449,174,473,0.368,342,527,0.649,1828,2010,11
3038,Nebraska,2011-12,30,12,18,0.4,6050,649,1521,0.427,455,922,0.493,194,599,0.324,335,437,0.767,1827,2011,12
3039,Binghamton,2015-16,30,8,22,0.267,6025,629,1614,0.39,458,1015,0.451,171,599,0.285,398,584,0.682,1827,2015,16
3040,Central Conn St,2016-17,29,6,23,0.207,5849,675,1602,0.421,529,1184,0.447,146,418,0.349,331,534,0.62,1827,2016,17
3041,San Diego,2010-11,30,6,24,0.2,6025,641,1519,0.422,478,1027,0.465,163,492,0.331,381,561,0.679,1826,2010,11
3042,UIC,2011-12,30,8,22,0.267,6050,636,1611,0.395,443,1018,0.435,193,593,0.325,361,539,0.67,1826,2011,12
3043,South Florida,2012-13,31,12,19,0.387,6351,647,1665,0.389,457,1057,0.432,190,608,0.313,338,487,0.694,1822,2012,13
3044,San Diego,2015-16,30,9,21,0.3,6000,630,1614,0.39,438,941,0.465,192,673,0.285,370,559,0.662,1822,2015,16
3045,Miami (OH),2011-12,30,9,21,0.3,6050,639,1472,0.434,419,853,0.491,220,619,0.355,323,463,0.698,1821,2011,12
3046,Navy,2013-14,30,9,21,0.3,6075,660,1645,0.401,459,1033,0.444,201,612,0.328,299,471,0.635,1820,2013,14
3047,Savannah State,2010-11,30,12,18,0.4,6075,640,1562,0.41,474,1028,0.461,166,534,0.311,372,563,0.661,1818,2010,11
3048,Monmouth,2010-11,30,9,21,0.3,6100,632,1551,0.407,454,1003,0.453,178,548,0.325,376,588,0.639,1818,2010,11
3049,Columbia,2014-15,28,13,15,0.464,5600,637,1453,0.438,393,783,0.502,244,670,0.364,298,416,0.716,1816,2014,15
3050,Fla. Atlantic,2014-15,29,9,20,0.31,5825,651,1562,0.417,439,952,0.461,212,610,0.348,301,447,0.673,1815,2014,15
3051,Maine,2014-15,30,3,27,0.1,6050,647,1599,0.405,450,990,0.455,197,609,0.323,321,442,0.726,1812,2014,15
3052,Dartmouth,2016-17,27,7,20,0.259,5425,631,1463,0.431,432,898,0.481,199,565,0.352,351,495,0.709,1812,2016,17
3053,Alabama A&M,2010-11,28,13,15,0.464,5625,633,1598,0.396,508,1164,0.436,125,434,0.288,417,668,0.624,1808,2010,11
3054,SC St.,2012-13,30,6,24,0.2,6075,678,1731,0.392,541,1246,0.434,137,485,0.282,315,487,0.647,1808,2012,13
3055,Northern Ariz.,2011-12,29,5,24,0.172,5825,661,1620,0.408,504,1139,0.442,157,481,0.326,325,469,0.693,1804,2011,12
3056,St. Francis (PA),2012-13,29,5,24,0.172,5900,633,1527,0.415,426,933,0.457,207,594,0.348,331,482,0.687,1804,2012,13
3057,Princeton,2012-13,28,17,11,0.607,5626,633,1369,0.462,445,893,0.498,188,476,0.395,349,483,0.723,1803,2012,13
3058,San Jose State,2012-13,29,9,20,0.31,5825,629,1669,0.377,482,1179,0.409,147,490,0.3,397,605,0.656,1802,2012,13
3059,Denver,2010-11,30,13,17,0.433,6100,601,1324,0.454,369,746,0.495,232,578,0.401,366,505,0.725,1800,2010,11
3060,St. Peter's,2011-12,31,5,26,0.161,6200,668,1646,0.406,514,1157,0.444,154,489,0.315,309,477,0.648,1799,2011,12
3061,Fresno State,2012-13,30,11,19,0.367,6050,610,1566,0.39,428,1043,0.41,182,523,0.348,396,593,0.668,1798,2012,13
3062,Fordham,2011-12,29,10,19,0.345,5825,663,1729,0.383,525,1227,0.428,138,502,0.275,333,546,0.61,1797,2011,12
3063,Alabama A&M,2014-15,29,9,20,0.31,5825,608,1533,0.397,442,956,0.462,166,577,0.288,415,643,0.645,1797,2014,15
3064,Fordham,2010-11,28,7,21,0.25,5600,648,1636,0.396,466,1095,0.426,182,541,0.336,317,503,0.63,1795,2010,11
3065,Cornell,2013-14,28,2,26,0.071,5648,652,1589,0.41,460,986,0.467,192,603,0.318,299,450,0.664,1795,2013,14
3066,Tennessee State,2014-15,31,5,26,0.161,6200,611,1548,0.395,441,1062,0.415,170,486,0.35,401,648,0.619,1793,2014,15
3067,Bradley,2015-16,32,5,27,0.156,6451,606,1596,0.38,441,1006,0.438,165,590,0.28,416,628,0.662,1793,2015,16
3068,Alabama A&M,2016-17,29,2,27,0.069,5875,628,1549,0.405,503,1102,0.456,125,447,0.28,411,614,0.669,1792,2016,17
3069,New Orleans,2012-13,26,8,18,0.308,5325,666,1513,0.44,575,1197,0.48,91,316,0.288,368,557,0.661,1791,2012,13
3070,St. Peter's,2012-13,30,9,21,0.3,6050,674,1633,0.413,527,1195,0.441,147,438,0.336,293,495,0.592,1788,2012,13
3071,Drexel,2014-15,30,11,19,0.367,6025,614,1569,0.391,438,1029,0.426,176,540,0.326,383,514,0.745,1787,2014,15
3072,Air Force,2011-12,29,13,16,0.448,5850,616,1383,0.445,424,814,0.521,192,569,0.337,362,537,0.674,1786,2011,12
3073,Rhode Island,2012-13,29,8,21,0.276,5900,616,1539,0.4,433,971,0.446,183,568,0.322,371,553,0.671,1786,2012,13
3074,Md.-East. Shore,2011-12,30,7,23,0.233,6051,644,1695,0.38,490,1140,0.43,154,555,0.277,343,538,0.638,1785,2011,12
3075,American,2015-16,31,12,19,0.387,6253,631,1487,0.424,436,915,0.477,195,572,0.341,328,471,0.696,1785,2015,16
3076,UMass-Lowell,2014-15,29,12,17,0.414,5875,610,1481,0.412,387,859,0.451,223,622,0.359,337,508,0.663,1780,2014,15
3077,Cal Poly,2010-11,30,15,15,0.5,6026,603,1551,0.389,413,941,0.439,190,610,0.311,383,577,0.664,1779,2010,11
3078,Charlotte,2018-19,29,8,21,0.276,5800,598,1442,0.415,407,827,0.492,191,615,0.311,389,524,0.742,1776,2018,19
3079,Centenary (LA),2010-11,30,1,29,0.033,6000,598,1507,0.397,467,1071,0.436,131,436,0.3,448,715,0.627,1775,2010,11
3080,SIU Edwardsville,2011-12,27,10,17,0.37,5401,626,1419,0.441,444,960,0.463,182,459,0.397,341,521,0.655,1775,2011,12
3081,New Hampshire,2011-12,29,13,16,0.448,5801,620,1547,0.401,408,930,0.439,212,617,0.344,322,529,0.609,1774,2011,12
3082,Miss Val St,2012-13,28,5,23,0.179,5626,593,1604,0.37,424,1047,0.405,169,557,0.303,410,633,0.648,1765,2012,13
3083,Alabama A&M,2011-12,28,7,21,0.25,5650,629,1538,0.409,482,1069,0.451,147,469,0.313,359,555,0.647,1764,2011,12
3084,Loyola (MD),2014-15,30,11,19,0.367,6145,607,1591,0.382,459,1135,0.404,148,456,0.325,402,599,0.671,1764,2014,15
3085,St. Francis (PA),2011-12,29,6,23,0.207,5800,652,1422,0.459,517,1021,0.506,135,401,0.337,324,496,0.653,1763,2011,12
3086,Binghamton,2011-12,31,2,29,0.065,6225,627,1579,0.397,495,1142,0.433,132,437,0.302,376,538,0.699,1762,2011,12
3087,Fairl. Dickinson,2011-12,29,3,26,0.103,5800,655,1589,0.412,546,1196,0.457,109,393,0.277,343,520,0.66,1762,2011,12
3088,TCU,2012-13,32,11,21,0.344,6403,631,1573,0.401,514,1197,0.429,117,376,0.311,382,636,0.601,1761,2012,13
3089,Savannah State,2014-15,31,9,22,0.29,6225,661,1612,0.41,557,1200,0.464,104,412,0.252,332,576,0.576,1758,2014,15
3090,Utah Valley,2014-15,30,11,19,0.367,6001,616,1540,0.4,447,974,0.459,169,566,0.299,357,514,0.695,1758,2014,15
3091,Tx AM-CC,2011-12,30,6,24,0.2,6051,627,1584,0.396,486,1123,0.433,141,461,0.306,360,600,0.6,1755,2011,12
3092,Howard,2010-11,30,6,24,0.2,6000,593,1576,0.376,444,1096,0.405,149,480,0.31,418,671,0.623,1753,2010,11
3093,Cal Poly,2014-15,29,13,16,0.448,5850,620,1589,0.39,454,1056,0.43,166,533,0.311,346,506,0.684,1752,2014,15
3094,La.-Monroe,2011-12,29,3,26,0.103,5825,637,1555,0.41,449,1039,0.432,188,516,0.364,288,441,0.653,1750,2011,12
3095,Eastern Ill.,2010-11,29,9,20,0.31,5825,640,1519,0.421,523,1156,0.452,117,363,0.322,352,486,0.724,1749,2010,11
3096,New Hampshire,2010-11,30,12,18,0.4,6075,609,1628,0.374,418,970,0.431,191,658,0.29,340,555,0.613,1749,2010,11
3097,Mt. St. Mary's,2011-12,29,8,21,0.276,5875,647,1525,0.424,488,1023,0.477,159,502,0.317,295,458,0.644,1748,2011,12
3098,Brown,2012-13,28,13,15,0.464,5725,610,1490,0.409,405,896,0.452,205,594,0.345,323,512,0.631,1748,2012,13
3099,Western Ill.,2014-15,28,8,20,0.286,5626,618,1543,0.401,430,1006,0.427,188,537,0.35,323,463,0.698,1747,2014,15
3100,USC Upstate,2010-11,30,5,25,0.167,6075,625,1680,0.372,411,945,0.435,214,735,0.291,282,470,0.6,1746,2010,11
,,,,,,,,School,School,School,School,School,School,School,School,School,School,School,School,School,,
,Schl,Season,G,W,L,W-L%,MP,FG,FGA,FG%,2P,2PA,2P%,3P,3PA,3P%,FT,FTA,FT%,PTS,Season,
3101,Columbia,2012-13,28,12,16,0.429,5600,604,1435,0.421,423,914,0.463,181,521,0.347,357,479,0.745,1746,2012,13
3102,Tx AM-CC,2012-13,29,6,23,0.207,5801,634,1560,0.406,496,1097,0.452,138,463,0.298,340,500,0.68,1746,2012,13
3103,New Hampshire,2012-13,29,9,20,0.31,5847,609,1566,0.389,430,985,0.437,179,581,0.308,348,545,0.639,1745,2012,13
3104,Southern Miss,2014-15,29,9,20,0.31,5849,618,1438,0.43,435,884,0.492,183,554,0.33,323,515,0.627,1742,2014,15
3105,New Hampshire,2018-19,29,5,24,0.172,5800,623,1656,0.376,362,869,0.417,261,787,0.332,235,385,0.61,1742,2018,19
3106,Southeastern LA,2011-12,29,12,17,0.414,5900,629,1530,0.411,501,1105,0.453,128,425,0.301,352,596,0.591,1738,2011,12
3107,La.-Monroe,2013-14,27,10,17,0.37,5500,628,1470,0.427,485,1020,0.475,143,450,0.318,339,536,0.632,1738,2013,14
3108,Jackson State,2011-12,31,7,24,0.226,6300,618,1621,0.381,485,1214,0.4,133,407,0.327,368,542,0.679,1737,2011,12
3109,American,2012-13,30,10,20,0.333,6075,616,1491,0.413,439,1002,0.438,177,489,0.362,326,460,0.709,1735,2012,13
3110,New Hampshire,2013-14,30,6,24,0.2,6032,584,1553,0.376,373,914,0.408,211,639,0.33,356,514,0.693,1735,2013,14
3111,Radford,2010-11,29,5,24,0.172,5850,598,1560,0.383,464,1109,0.418,134,451,0.297,404,645,0.626,1734,2010,11
3112,Sacramento St.,2010-11,28,7,21,0.25,5700,593,1479,0.401,438,972,0.451,155,507,0.306,388,570,0.681,1729,2010,11
3113,Dartmouth,2011-12,30,5,25,0.167,6025,592,1504,0.394,438,1041,0.421,154,463,0.333,389,552,0.705,1727,2011,12
3114,Utah,2011-12,31,6,25,0.194,6225,606,1496,0.405,443,964,0.46,163,532,0.306,345,518,0.666,1720,2011,12
3115,Western Ill.,2010-11,30,7,23,0.233,6000,595,1439,0.413,435,982,0.443,160,457,0.35,369,558,0.661,1719,2010,11
3116,Pepperdine,2011-12,29,10,19,0.345,5820,603,1523,0.396,459,1069,0.429,144,454,0.317,369,560,0.659,1719,2011,12
3117,Dartmouth,2012-13,28,9,19,0.321,5625,598,1467,0.408,439,995,0.441,159,472,0.337,364,499,0.729,1719,2012,13
3118,UMass-Lowell,2013-14,28,10,18,0.357,5626,570,1447,0.394,378,859,0.44,192,588,0.327,386,548,0.704,1718,2013,14
3119,Loyola (IL),2011-12,30,7,23,0.233,6075,612,1452,0.421,495,1075,0.46,117,377,0.31,376,540,0.696,1717,2011,12
3120,Northern Ill.,2011-12,31,5,26,0.161,6200,594,1602,0.371,409,1018,0.402,185,584,0.317,343,511,0.671,1716,2011,12
3121,Idaho State,2012-13,30,6,24,0.2,6049,587,1444,0.407,424,929,0.456,163,515,0.317,373,548,0.681,1710,2012,13
3122,Southern Utah,2013-14,29,2,27,0.069,5824,591,1462,0.404,460,1061,0.434,131,401,0.327,397,576,0.689,1710,2013,14
3123,Navy,2012-13,31,8,23,0.258,6225,628,1605,0.391,456,1077,0.423,172,528,0.326,281,448,0.627,1709,2012,13
3124,Eastern Mich.,2011-12,32,14,18,0.438,6450,583,1555,0.375,430,1055,0.408,153,500,0.306,385,556,0.692,1704,2011,12
3125,Southern,2010-11,30,4,26,0.133,6050,610,1597,0.382,457,1080,0.423,153,517,0.296,328,550,0.596,1701,2010,11
3126,UCSB,2016-17,28,6,22,0.214,5625,622,1651,0.377,468,1120,0.418,154,531,0.29,303,478,0.634,1701,2016,17
3127,SIU Edwardsville,2012-13,27,9,18,0.333,5400,609,1428,0.426,450,990,0.455,159,438,0.363,322,481,0.669,1699,2012,13
3128,Penn,2014-15,28,9,19,0.321,5626,599,1379,0.434,444,931,0.477,155,448,0.346,334,495,0.675,1687,2014,15
3129,USC,2011-12,32,6,26,0.188,6450,642,1658,0.387,515,1189,0.433,127,469,0.271,272,445,0.611,1683,2011,12
3130,UMBC,2014-15,30,4,26,0.133,6025,591,1441,0.41,438,972,0.451,153,469,0.326,347,539,0.644,1682,2014,15
3131,Navy,2011-12,29,3,26,0.103,5878,594,1464,0.406,437,905,0.483,157,559,0.281,333,487,0.684,1678,2011,12
3132,Binghamton,2012-13,30,3,27,0.1,6000,588,1580,0.372,432,1034,0.418,156,546,0.286,344,533,0.645,1676,2012,13
3133,Dartmouth,2010-11,28,5,23,0.179,5629,605,1530,0.395,463,1095,0.423,142,435,0.326,315,452,0.697,1667,2010,11
3134,Towson,2011-12,32,1,31,0.031,6400,580,1581,0.367,472,1181,0.4,108,400,0.27,379,647,0.586,1647,2011,12
3135,La.-Monroe,2012-13,27,4,23,0.148,5450,602,1409,0.427,441,947,0.466,161,462,0.348,256,444,0.577,1621,2012,13
3136,Northern Ill.,2012-13,30,5,25,0.167,6025,561,1565,0.358,425,1072,0.396,136,493,0.276,361,553,0.653,1619,2012,13
3137,Howard,2012-13,31,7,24,0.226,6200,572,1567,0.365,471,1159,0.406,101,408,0.248,370,558,0.663,1615,2012,13
3138,San Jose State,2014-15,30,2,28,0.067,6025,553,1559,0.355,357,891,0.401,196,668,0.293,310,475,0.653,1612,2014,15
3139,Florida A&M,2014-15,29,2,27,0.069,5800,560,1500,0.373,441,1079,0.409,119,421,0.283,368,567,0.649,1607,2014,15
3140,Northern Ky.,2012-13,27,11,16,0.407,5399,553,1363,0.406,349,746,0.468,204,617,0.331,272,387,0.703,1582,2012,13
3141,Md.-East. Shore,2012-13,28,2,26,0.071,5650,538,1507,0.357,415,1055,0.393,123,452,0.272,336,532,0.632,1535,2012,13
3142,Grambling,2011-12,28,4,24,0.143,5625,520,1452,0.358,405,1035,0.391,115,417,0.276,358,519,0.69,1513,2011,12
3143,Grambling,2014-15,29,2,27,0.069,5800,512,1417,0.361,407,1051,0.387,105,366,0.287,380,584,0.651,1509,2014,15
3144,Grambling,2012-13,28,0,28,0,5599,519,1436,0.361,376,978,0.384,143,458,0.312,210,358,0.587,1391,2012,13