Date,Schl,Opp,Result,MP,FG,FGA,FG%,2P,2PA,2P%,3P,3PA,3P%,FT,FTA,FT%,PTS
3/17/16,Kansas,Austin Peay,W 105-79,200,39,70,0.557,33,54,0.611,6,16,0.375,21,27,0.778,105
3/17/17,UNC,Texas Southern,W 103-64,200,38,75,0.507,30,53,0.566,8,22,0.364,19,26,0.731,103
3/16/18,Xavier,Texas Southern,W 102-83,200,35,64,0.547,24,40,0.6,11,24,0.458,21,32,0.656,102
3/25/16,UNC,Indiana,W 101-86,200,32,62,0.516,21,42,0.5,11,20,0.55,26,33,0.788,101
3/16/17,Arizona,North Dakota,W 100-82,200,36,62,0.581,32,51,0.627,4,11,0.364,24,28,0.857,100
3/17/17,Kansas,UC-Davis,W 100-62,200,36,64,0.563,25,39,0.641,11,25,0.44,17,20,0.85,100
3/17/16,Indiana,Chattanooga,W 99-74,200,37,57,0.649,27,40,0.675,10,17,0.588,15,18,0.833,99
3/22/18,Michigan,Texas A&M,W 99-72,200,39,63,0.619,25,39,0.641,14,24,0.583,7,8,0.875,99
3/28/19,Purdue,Tennessee,W 99-94 (OT),225,34,63,0.54,19,32,0.594,15,31,0.484,16,33,0.485,99
3/23/17,Kansas,Purdue,W 98-66,200,34,62,0.548,19,34,0.559,15,28,0.536,15,22,0.682,98
3/17/17,UCLA,Kent State,W 97-80,200,37,59,0.627,30,45,0.667,7,14,0.5,16,23,0.696,97
3/29/19,Auburn,UNC,W 97-80,200,36,66,0.545,19,29,0.655,17,37,0.459,8,17,0.471,97
3/15/16,Fla. Gulf Coast,Fairl. Dickinson,W 96-65,200,34,57,0.596,26,34,0.765,8,23,0.348,20,34,0.588,96
4/2/16,Villanova,Oklahoma,W 95-51,200,35,49,0.714,24,31,0.774,11,18,0.611,14,19,0.737,95
3/14/17,Kansas State,Wake Forest,W 95-88,200,31,47,0.66,25,31,0.806,6,16,0.375,27,36,0.75,95
3/17/18,Kentucky,Buffalo,W 95-75,200,36,64,0.563,29,49,0.592,7,15,0.467,16,23,0.696,95
3/31/18,Villanova,Kansas,W 95-79,200,36,65,0.554,18,25,0.72,18,40,0.45,5,7,0.714,95
3/22/19,Oklahoma,Ole Miss,W 95-72,200,34,59,0.576,28,46,0.609,6,13,0.462,21,26,0.808,95
3/17/16,Iowa State,Iona,W 94-81,200,32,64,0.5,22,42,0.524,10,22,0.455,20,25,0.8,94
3/15/18,Seton Hall,NC State,W 94-83,200,28,58,0.483,21,37,0.568,7,21,0.333,31,39,0.795,94
3/18/18,West Virginia,Marshall,W 94-71,200,33,66,0.5,21,41,0.512,12,25,0.48,16,18,0.889,94
3/28/19,Tennessee,Purdue,L 94-99 (OT),225,34,68,0.5,22,44,0.5,12,24,0.5,14,28,0.5,94
3/17/16,Duke,UNC Wilmington,W 93-85,200,29,54,0.537,25,39,0.641,4,15,0.267,31,43,0.721,93
3/17/17,Oregon,Iona,W 93-77,200,35,63,0.556,26,40,0.65,9,23,0.391,14,21,0.667,93
3/17/17,South Carolina,Marquette,W 93-73,200,36,68,0.529,28,44,0.636,8,24,0.333,13,19,0.684,93
3/18/16,Texas A&M,Green Bay,W 92-65,200,32,57,0.561,25,38,0.658,7,19,0.368,21,28,0.75,92
3/20/16,Texas A&M,Northern Iowa,W 92-88 (2OT),250,31,71,0.437,24,39,0.615,7,32,0.219,23,34,0.676,92
3/24/16,Villanova,Miami (FL),W 92-69,200,32,51,0.627,22,36,0.611,10,15,0.667,18,19,0.947,92
3/17/17,Michigan,Oklahoma State,W 92-91,200,29,56,0.518,13,27,0.481,16,29,0.552,18,22,0.818,92
3/24/17,UNC,Butler,W 92-80,200,31,57,0.544,22,33,0.667,9,24,0.375,21,33,0.636,92
3/18/16,Oregon,Holy Cross,W 91-52,200,34,61,0.557,28,41,0.683,6,20,0.3,17,22,0.773,91
3/17/17,Baylor,New Mexico St.,W 91-73,200,35,61,0.574,31,53,0.585,4,8,0.5,17,19,0.895,91
3/17/17,Oklahoma State,Michigan,L 91-92,200,35,64,0.547,28,48,0.583,7,16,0.438,14,16,0.875,91
3/18/17,Xavier,Florida State,W 91-66,200,30,54,0.556,19,37,0.514,11,17,0.647,20,26,0.769,91
3/22/19,Buffalo,Arizona State,W 91-74,200,31,60,0.517,21,33,0.636,10,27,0.37,19,26,0.731,91
3/18/16,Middle Tenn.,Michigan State,W 90-81,200,33,59,0.559,22,40,0.55,11,19,0.579,13,21,0.619,90
3/19/17,Kansas,Michigan State,W 90-70,200,34,64,0.531,26,44,0.591,8,20,0.4,14,15,0.933,90
3/17/18,Gonzaga,Ohio State,W 90-84,200,31,58,0.534,22,36,0.611,9,22,0.409,19,31,0.613,90
3/23/18,Villanova,West Virginia,W 90-78,200,27,54,0.5,14,30,0.467,13,24,0.542,23,27,0.852,90
3/23/19,Florida State,Murray State,W 90-62,200,36,71,0.507,25,44,0.568,11,27,0.407,7,9,0.778,90
3/15/18,Duke,Iona,W 89-67,200,36,67,0.537,23,37,0.622,13,30,0.433,4,8,0.5,89
3/15/18,Buffalo,Arizona,W 89-68,200,34,62,0.548,19,32,0.594,15,30,0.5,6,7,0.857,89
3/23/19,Auburn,Kansas,W 89-75,200,32,61,0.525,19,31,0.613,13,30,0.433,12,15,0.8,89
3/20/16,Northern Iowa,Texas A&M,L 88-92 (2OT),250,27,69,0.391,15,35,0.429,12,34,0.353,22,27,0.815,88
3/27/16,UNC,Notre Dame,W 88-74,200,32,52,0.615,28,39,0.718,4,13,0.308,20,24,0.833,88
3/14/17,Wake Forest,Kansas State,L 88-95,200,25,53,0.472,16,26,0.615,9,27,0.333,29,32,0.906,88
3/19/17,South Carolina,Duke,W 88-81,200,27,63,0.429,20,41,0.488,7,22,0.318,27,32,0.844,88
3/22/19,UNC,Iona,W 88-73,200,35,75,0.467,28,53,0.528,7,22,0.318,11,15,0.733,88
3/20/16,Villanova,Iowa,W 87-68,200,32,54,0.593,22,35,0.629,10,19,0.526,13,17,0.765,87
3/17/17,Duke,Troy,W 87-65,200,29,62,0.468,16,34,0.471,13,28,0.464,16,23,0.696,87
3/15/18,Villanova,Radford,W 87-61,200,31,52,0.596,17,25,0.68,14,27,0.519,11,14,0.786,87
3/16/18,Nevada,Texas,W 87-83 (OT),225,32,63,0.508,21,34,0.618,11,29,0.379,12,20,0.6,87
3/17/18,Duke,Rhode Island,W 87-62,200,29,51,0.569,19,30,0.633,10,21,0.476,19,24,0.792,87
3/21/19,Kansas,Northeastern,W 87-53,200,34,61,0.557,26,39,0.667,8,22,0.364,11,12,0.917,87
3/21/19,Gonzaga,Fairl. Dickinson,W 87-49,200,34,64,0.531,25,43,0.581,9,21,0.429,10,16,0.625,87
3/23/19,Purdue,Villanova,W 87-61,200,29,54,0.537,13,24,0.542,16,30,0.533,13,16,0.813,87
3/18/16,Villanova,UNC Asheville,W 86-56,200,33,57,0.579,20,29,0.69,13,28,0.464,7,11,0.636,86
3/25/16,Indiana,UNC,L 86-101,200,25,61,0.41,12,30,0.4,13,31,0.419,23,26,0.885,86
3/16/17,Florida State,Fla. Gulf Coast,W 86-80,200,30,54,0.556,28,41,0.683,2,13,0.154,24,39,0.615,86
3/16/17,West Virginia,Bucknell,W 86-80,200,30,66,0.455,25,55,0.455,5,11,0.455,21,29,0.724,86
3/24/17,Kentucky,UCLA,W 86-75,200,31,63,0.492,21,40,0.525,10,23,0.435,14,17,0.824,86
3/15/18,Alabama,Virginia Tech,W 86-83,200,30,50,0.6,22,32,0.688,8,18,0.444,18,27,0.667,86
3/18/18,Texas A&M,UNC,W 86-65,200,31,60,0.517,21,36,0.583,10,24,0.417,14,21,0.667,86
3/21/19,Minnesota,Louisville,W 86-76,200,29,58,0.5,18,31,0.581,11,27,0.407,17,26,0.654,86
3/17/16,UNC Wilmington,Duke,L 85-93,200,30,68,0.441,19,42,0.452,11,26,0.423,14,19,0.737,85
3/17/16,Kentucky,Stony Brook,W 85-57,200,33,63,0.524,29,50,0.58,4,13,0.308,15,17,0.882,85
3/17/16,Little Rock,Purdue,W 85-83 (2OT),250,30,77,0.39,21,50,0.42,9,27,0.333,16,28,0.571,85
3/19/16,UNC,Providence,W 85-66,200,31,59,0.525,27,45,0.6,4,14,0.286,19,21,0.905,85
3/20/16,Oklahoma,VCU,W 85-81,200,29,60,0.483,21,34,0.618,8,26,0.308,19,25,0.76,85
3/16/17,Saint Mary's,VCU,W 85-77,200,25,45,0.556,19,28,0.679,6,17,0.353,29,39,0.744,85
3/16/18,West Virginia,Murray State,W 85-68,200,32,62,0.516,28,51,0.549,4,11,0.364,17,24,0.708,85
3/25/18,Kansas,Duke,W 85-81 (OT),225,30,69,0.435,17,33,0.515,13,36,0.361,12,15,0.8,85
3/22/19,Duke,North Dakota St.,W 85-62,200,33,65,0.508,25,46,0.543,8,19,0.421,11,17,0.647,85
4/8/19,Virginia,Texas Tech,W 85-77 (OT),225,27,59,0.458,16,35,0.457,11,24,0.458,20,23,0.87,85
3/25/16,Virginia,Iowa State,W 84-71,200,32,57,0.561,28,46,0.609,4,11,0.364,16,24,0.667,84
3/16/17,Iowa State,Nevada,W 84-73,200,30,54,0.556,22,35,0.629,8,19,0.421,16,18,0.889,84
3/16/17,Wisconsin,Virginia Tech,W 84-74,200,26,60,0.433,13,29,0.448,13,31,0.419,19,25,0.76,84
3/17/17,Rhode Island,Creighton,W 84-72,200,26,58,0.448,22,37,0.595,4,21,0.19,28,31,0.903,84
3/24/17,Florida,Wisconsin,W 84-83 (OT),225,28,62,0.452,20,40,0.5,8,22,0.364,20,28,0.714,84
3/16/18,UNC,Lipscomb,W 84-66,200,31,60,0.517,22,38,0.579,9,22,0.409,13,18,0.722,84
3/17/18,Ohio State,Gonzaga,L 84-90,200,30,66,0.455,19,40,0.475,11,26,0.423,13,16,0.813,84
3/18/18,Clemson,Auburn,W 84-53,200,29,61,0.475,19,35,0.543,10,26,0.385,16,23,0.696,84
3/21/19,Wofford,Seton Hall,W 84-68,200,26,54,0.481,13,26,0.5,13,28,0.464,19,23,0.826,84
3/22/19,Houston,Georgia State,W 84-55,200,33,64,0.516,25,35,0.714,8,29,0.276,10,13,0.769,84
3/17/16,UNC,Fla. Gulf Coast,W 83-67,200,31,72,0.431,24,51,0.471,7,21,0.333,14,19,0.737,83
3/17/16,Purdue,Little Rock,L 83-85 (2OT),250,26,62,0.419,17,34,0.5,9,28,0.321,22,28,0.786,83
4/2/16,UNC,Syracuse,W 83-66,200,35,65,0.538,31,48,0.646,4,17,0.235,9,11,0.818,83
3/18/17,West Virginia,Notre Dame,W 83-71,200,27,54,0.5,19,40,0.475,8,14,0.571,21,26,0.808,83
3/24/17,Wisconsin,Florida,L 83-84 (OT),225,28,55,0.509,21,38,0.553,7,17,0.412,20,30,0.667,83
3/25/17,Gonzaga,Xavier,W 83-59,200,29,61,0.475,17,37,0.459,12,24,0.5,13,25,0.52,83
3/15/18,Rhode Island,Oklahoma,W 83-78 (OT),225,30,77,0.39,19,49,0.388,11,28,0.393,12,20,0.6,83
3/15/18,NC State,Seton Hall,L 83-94,200,28,61,0.459,17,31,0.548,11,30,0.367,16,27,0.593,83
3/15/18,Virginia Tech,Alabama,L 83-86,200,30,54,0.556,21,36,0.583,9,18,0.5,14,20,0.7,83
3/16/18,Texas,Nevada,L 83-87 (OT),225,31,67,0.463,20,43,0.465,11,24,0.458,10,18,0.556,83
3/16/18,Texas Southern,Xavier,L 83-102,200,26,65,0.4,18,40,0.45,8,25,0.32,23,27,0.852,83
3/17/18,Kansas,Seton Hall,W 83-79,200,28,56,0.5,19,35,0.543,9,21,0.429,18,26,0.692,83
3/21/19,Murray State,Marquette,W 83-64,200,30,56,0.536,21,38,0.553,9,18,0.5,14,24,0.583,83
3/23/19,Gonzaga,Baylor,W 83-71,200,31,57,0.544,24,37,0.649,7,20,0.35,14,21,0.667,83
3/24/19,Tennessee,Iowa,W 83-77 (OT),225,28,60,0.467,20,40,0.5,8,20,0.4,19,23,0.826,83
3/18/16,Oklahoma,Cal St Bakersfield,W 82-68,200,28,56,0.5,17,36,0.472,11,20,0.55,15,25,0.6,82
3/19/16,Gonzaga,Utah,W 82-59,200,34,61,0.557,25,42,0.595,9,19,0.474,5,6,0.833,82
3/24/16,Oregon,Duke,W 82-68,200,32,65,0.492,22,42,0.524,10,23,0.435,8,17,0.471,82
3/16/17,North Dakota,Arizona,L 82-100,200,32,69,0.464,22,47,0.468,10,22,0.455,8,16,0.5,82
3/19/17,Baylor,USC,W 82-78,200,31,61,0.508,24,42,0.571,7,19,0.368,13,15,0.867,82
3/16/18,Michigan State,Bucknell,W 82-78,200,31,58,0.534,26,41,0.634,5,17,0.294,15,22,0.682,82
3/19/19,Fairl. Dickinson,Prairie View,W 82-76,200,30,55,0.545,21,34,0.618,9,21,0.429,13,19,0.684,82
3/17/16,Iona,Iowa State,L 81-94,200,31,64,0.484,24,40,0.6,7,24,0.292,12,18,0.667,81
3/17/16,Virginia,Hampton,W 81-45,200,32,58,0.552,20,33,0.606,12,25,0.48,5,8,0.625,81
3/18/16,Michigan State,Middle Tenn.,L 81-90,200,30,54,0.556,19,30,0.633,11,24,0.458,10,15,0.667,81
3/20/16,VCU,Oklahoma,L 81-85,200,30,66,0.455,19,35,0.543,11,31,0.355,10,16,0.625,81
3/16/17,Middle Tenn.,Minnesota,W 81-72,200,28,58,0.483,21,45,0.467,7,13,0.538,18,27,0.667,81
3/19/17,Duke,South Carolina,L 81-88,200,22,53,0.415,12,26,0.462,10,27,0.37,27,29,0.931,81
3/15/18,Ohio State,S Dakota St.,W 81-73,200,27,72,0.375,15,32,0.469,12,40,0.3,15,19,0.789,81
3/16/18,Marshall,Wichita State,W 81-75,200,28,60,0.467,19,37,0.514,9,23,0.391,16,22,0.727,81
3/17/18,Villanova,Alabama,W 81-58,200,25,63,0.397,8,22,0.364,17,41,0.415,14,16,0.875,81
3/25/18,Duke,Kansas,L 81-85 (OT),225,30,70,0.429,23,41,0.561,7,29,0.241,14,18,0.778,81
3/19/19,Belmont,Temple,W 81-70,200,28,53,0.528,19,30,0.633,9,23,0.391,16,21,0.762,81
3/24/19,UNC,Washington,W 81-59,200,32,63,0.508,23,42,0.548,9,21,0.429,8,10,0.8,81
3/17/16,Utah,Fresno State,W 80-69,200,27,50,0.54,20,32,0.625,7,18,0.389,19,22,0.864,80
3/26/16,Oklahoma,Oregon,W 80-68,200,27,58,0.466,15,34,0.441,12,24,0.5,14,17,0.824,80
3/16/17,Florida,ETSU,W 80-65,200,26,54,0.481,19,32,0.594,7,22,0.318,21,27,0.778,80
3/16/17,Fla. Gulf Coast,Florida State,L 80-86,200,29,70,0.414,21,42,0.5,8,28,0.286,14,20,0.7,80
3/16/17,Purdue,Vermont,W 80-70,200,31,60,0.517,22,40,0.55,9,20,0.45,9,14,0.643,80
3/16/17,Bucknell,West Virginia,L 80-86,200,27,59,0.458,18,39,0.462,9,20,0.45,17,23,0.739,80
3/17/17,Kent State,UCLA,L 80-97,200,31,71,0.437,22,49,0.449,9,22,0.409,9,12,0.75,80
3/18/17,Purdue,Iowa State,W 80-76,200,31,64,0.484,23,38,0.605,8,26,0.308,10,15,0.667,80
3/24/17,Butler,UNC,L 80-92,200,27,62,0.435,19,34,0.559,8,28,0.286,18,21,0.857,80
3/23/18,Kansas,Clemson,W 80-76,200,28,60,0.467,18,38,0.474,10,22,0.455,14,22,0.636,80
3/22/19,Liberty,Miss. St.,W 80-76,200,24,52,0.462,12,27,0.444,12,25,0.48,20,25,0.8,80
3/29/19,Michigan State,LSU,W 80-63,200,31,66,0.47,18,34,0.529,13,32,0.406,5,8,0.625,80
3/29/19,UNC,Auburn,L 80-97,200,28,65,0.431,21,37,0.568,7,28,0.25,17,22,0.773,80
3/30/19,Virginia,Purdue,W 80-75 (OT),225,27,65,0.415,18,38,0.474,9,27,0.333,17,20,0.85,80
3/17/16,Yale,Baylor,W 79-75,200,26,49,0.531,21,33,0.636,5,16,0.313,22,29,0.759,79
3/17/16,Austin Peay,Kansas,L 79-105,200,25,61,0.41,21,46,0.457,4,15,0.267,25,37,0.676,79
3/17/16,Miami (FL),Buffalo,W 79-72,200,24,54,0.444,19,39,0.487,5,15,0.333,26,34,0.765,79
3/18/16,Maryland,S Dakota St.,W 79-74,200,23,45,0.511,14,22,0.636,9,23,0.391,24,27,0.889,79
3/24/16,Kansas,Maryland,W 79-63,200,29,62,0.468,26,53,0.491,3,9,0.333,18,21,0.857,79
3/17/17,Kentucky,Northern Ky.,W 79-70,200,27,61,0.443,24,44,0.545,3,17,0.176,22,28,0.786,79
3/18/17,Gonzaga,Northwestern,W 79-73,200,26,59,0.441,22,43,0.512,4,16,0.25,23,36,0.639,79
3/19/17,UCLA,Cincinnati,W 79-67,200,31,62,0.5,20,34,0.588,11,28,0.393,6,10,0.6,79
3/16/18,Butler,Arkansas,W 79-62,200,29,59,0.492,18,33,0.545,11,26,0.423,10,12,0.833,79
3/16/18,Clemson,New Mexico St.,W 79-68,201,33,59,0.559,27,45,0.6,6,14,0.429,7,9,0.778,79
3/17/18,Seton Hall,Kansas,L 79-83,200,29,64,0.453,19,40,0.475,10,24,0.417,11,16,0.688,79
3/31/18,Kansas,Villanova,L 79-95,200,28,62,0.452,21,41,0.512,7,21,0.333,16,20,0.8,79
4/2/18,Villanova,Michigan,W 79-62,200,27,57,0.474,17,30,0.567,10,27,0.37,15,20,0.75,79
3/21/19,LSU,Yale,W 79-74,200,28,61,0.459,24,44,0.545,4,17,0.235,19,28,0.679,79
3/21/19,Maryland,Belmont,W 79-77,200,30,69,0.435,24,47,0.511,6,22,0.273,13,20,0.65,79
3/21/19,Kentucky,Abilene Christ.,W 79-44,200,30,56,0.536,26,42,0.619,4,14,0.286,15,19,0.789,79
3/22/19,Iowa,Cincinnati,W 79-72,200,29,53,0.547,18,31,0.581,11,22,0.5,10,16,0.625,79
3/18/16,St. Joseph's,Cincinnati,W 78-76,200,28,58,0.483,19,34,0.559,9,24,0.375,13,17,0.765,78
3/19/16,Iowa State,Little Rock,W 78-61,200,30,53,0.566,19,32,0.594,11,21,0.524,7,16,0.438,78
3/17/17,Louisville,Jacksonville St.,W 78-63,200,31,64,0.484,26,49,0.531,5,15,0.333,11,14,0.786,78
3/17/17,Michigan State,Miami (FL),W 78-58,200,30,53,0.566,24,33,0.727,6,20,0.3,12,14,0.857,78
3/19/17,USC,Baylor,L 78-82,200,30,55,0.545,21,33,0.636,9,22,0.409,9,10,0.9,78
3/15/18,Oklahoma,Rhode Island,L 78-83 (OT),225,29,69,0.42,25,49,0.51,4,20,0.2,16,24,0.667,78
3/15/18,Kentucky,Davidson,W 78-73,200,26,51,0.51,26,45,0.578,0,6,0,26,32,0.813,78
3/16/18,Bucknell,Michigan State,L 78-82,200,23,55,0.418,12,35,0.343,11,20,0.55,21,28,0.75,78
3/23/18,West Virginia,Villanova,L 78-90,200,27,70,0.386,20,42,0.476,7,28,0.25,17,23,0.739,78
3/23/18,Texas Tech,Purdue,W 78-65,200,28,59,0.475,23,42,0.548,5,17,0.294,17,18,0.944,78
3/24/18,Loyola (IL),Kansas State,W 78-62,200,27,47,0.574,18,29,0.621,9,18,0.5,15,18,0.833,78
3/20/19,North Dakota St.,N.C. Central,W 78-74,200,25,52,0.481,16,32,0.5,9,20,0.45,19,24,0.792,78
3/21/19,Auburn,New Mexico St.,W 78-77,200,26,57,0.456,14,26,0.538,12,31,0.387,14,21,0.667,78
3/21/19,Baylor,Syracuse,W 78-69,200,28,52,0.538,12,18,0.667,16,34,0.471,6,9,0.667,78
3/22/19,Washington,Utah State,W 78-61,200,25,51,0.49,15,34,0.441,10,17,0.588,18,21,0.857,78
3/24/19,Texas Tech,Buffalo,W 78-58,200,27,56,0.482,22,40,0.55,5,16,0.313,19,25,0.76,78
3/18/16,Hawaii,California,W 77-66,200,27,52,0.519,24,38,0.632,3,14,0.214,20,25,0.8,77
3/19/16,Virginia,Butler,W 77-69,200,29,52,0.558,27,42,0.643,2,10,0.2,17,21,0.81,77
3/24/16,Oklahoma,Texas A&M,W 77-63,200,31,63,0.492,20,38,0.526,11,25,0.44,4,9,0.444,77
4/4/16,Villanova,UNC,W 77-74,200,28,48,0.583,20,34,0.588,8,14,0.571,13,17,0.765,77
3/16/17,VCU,Saint Mary's,L 77-85,200,29,65,0.446,27,52,0.519,2,13,0.154,17,26,0.654,77
3/17/17,Arkansas,Seton Hall,W 77-71,200,28,59,0.475,25,52,0.481,3,7,0.429,18,23,0.783,77
3/17/17,Iona,Oregon,L 77-93,200,28,64,0.438,18,38,0.474,10,26,0.385,11,16,0.688,77
3/26/17,South Carolina,Florida,W 77-70,200,26,53,0.491,24,43,0.558,2,10,0.2,23,31,0.742,77
4/1/17,Gonzaga,South Carolina,W 77-73,200,29,60,0.483,20,41,0.488,9,19,0.474,10,13,0.769,77
4/1/17,UNC,Oregon,W 77-76,200,25,68,0.368,17,47,0.362,8,21,0.381,19,27,0.704,77
3/15/18,Florida,St. Bonaventure,W 77-62,200,27,65,0.415,17,33,0.515,10,32,0.313,13,18,0.722,77
3/21/19,New Mexico St.,Auburn,L 77-78,200,25,51,0.49,18,26,0.692,7,25,0.28,20,27,0.741,77
3/21/19,Belmont,Maryland,L 77-79,200,27,65,0.415,18,37,0.486,9,28,0.321,14,20,0.7,77
3/22/19,Tennessee,Colgate,W 77-70,200,30,64,0.469,21,38,0.553,9,26,0.346,8,11,0.727,77
3/24/19,Iowa,Tennessee,L 77-83 (OT),225,23,59,0.39,16,38,0.421,7,21,0.333,24,32,0.75,77
3/24/19,Duke,UCF,W 77-76,200,30,67,0.448,20,42,0.476,10,25,0.4,7,12,0.583,77
3/31/19,Auburn,Kentucky,W 77-71 (OT),225,26,65,0.4,19,42,0.452,7,23,0.304,18,24,0.75,77
4/8/19,Texas Tech,Virginia,L 77-85 (OT),225,27,63,0.429,17,33,0.515,10,30,0.333,13,15,0.867,77
3/18/16,Cincinnati,St. Joseph's,L 76-78,200,28,55,0.509,18,31,0.581,10,24,0.417,10,13,0.769,76
3/20/16,Notre Dame,Stephen F. Austin,W 76-75,200,29,51,0.569,23,34,0.676,6,17,0.353,12,16,0.75,76
3/16/17,Butler,Winthrop,W 76-64,200,24,49,0.49,16,30,0.533,8,19,0.421,20,30,0.667,76
3/16/17,Xavier,Maryland,W 76-65,200,25,50,0.5,16,27,0.593,9,23,0.391,17,24,0.708,76
3/16/17,Villanova,Mt. St. Mary's,W 76-56,200,31,60,0.517,25,43,0.581,6,17,0.353,8,11,0.727,76
3/16/17,Virginia,UNC Wilmington,W 76-71,200,26,52,0.5,19,35,0.543,7,17,0.412,17,25,0.68,76
3/18/17,Iowa State,Purdue,L 76-80,200,30,60,0.5,23,37,0.622,7,23,0.304,9,14,0.643,76
4/1/17,Oregon,UNC,L 76-77,200,22,58,0.379,15,32,0.469,7,26,0.269,25,28,0.893,76
3/15/18,Kansas,Penn,W 76-60,200,27,61,0.443,20,44,0.455,7,17,0.412,15,17,0.882,76
3/18/18,Purdue,Butler,W 76-73,200,26,52,0.5,15,28,0.536,11,24,0.458,13,18,0.722,76
3/23/18,Clemson,Kansas,L 76-80,200,28,65,0.431,22,45,0.489,6,20,0.3,14,19,0.737,76
3/19/19,Prairie View,Fairl. Dickinson,L 76-82,200,28,64,0.438,13,36,0.361,15,28,0.536,5,7,0.714,76
3/21/19,Louisville,Minnesota,L 76-86,200,26,59,0.441,17,33,0.515,9,26,0.346,15,17,0.882,76
3/21/19,Florida State,Vermont,W 76-69,200,21,55,0.382,18,43,0.419,3,12,0.25,31,37,0.838,76
3/21/19,Michigan State,Bradley,W 76-65,200,23,54,0.426,18,35,0.514,5,19,0.263,25,26,0.962,76
3/22/19,Miss. St.,Liberty,L 76-80,200,25,52,0.481,17,30,0.567,8,22,0.364,18,23,0.783,76
3/24/19,UCF,Duke,L 76-77,200,26,54,0.481,17,36,0.472,9,18,0.5,15,20,0.75,76
3/17/16,Baylor,Yale,L 75-79,200,30,68,0.441,24,52,0.462,6,16,0.375,9,15,0.6,75
3/18/16,VCU,Oregon State,W 75-67,200,27,56,0.482,23,36,0.639,4,20,0.2,17,21,0.81,75
3/18/16,Northern Iowa,Texas,W 75-72,200,21,43,0.488,13,23,0.565,8,20,0.4,25,32,0.781,75
3/20/16,Stephen F. Austin,Notre Dame,L 75-76,200,29,64,0.453,21,37,0.568,8,27,0.296,9,9,1,75
3/20/16,Syracuse,Middle Tenn.,W 75-50,200,27,49,0.551,19,29,0.655,8,20,0.4,13,22,0.591,75
3/15/17,USC,Providence,W 75-71,200,24,57,0.421,17,38,0.447,7,19,0.368,20,27,0.741,75
3/17/17,Cincinnati,Kansas State,W 75-61,200,27,43,0.628,22,32,0.688,5,11,0.455,16,22,0.727,75
3/19/17,Oregon,Rhode Island,W 75-72,200,25,52,0.481,18,36,0.5,7,16,0.438,18,27,0.667,75
3/24/17,UCLA,Kentucky,L 75-86,200,29,55,0.527,20,32,0.625,9,23,0.391,8,13,0.615,75
3/26/17,UNC,Kentucky,W 75-73,200,27,58,0.466,24,43,0.558,3,15,0.2,18,26,0.692,75
3/16/18,Wichita State,Marshall,L 75-81,200,27,65,0.415,19,36,0.528,8,29,0.276,13,17,0.765,75
3/17/18,Buffalo,Kentucky,L 75-95,200,26,67,0.388,19,36,0.528,7,31,0.226,16,22,0.727,75
3/18/18,Nevada,Cincinnati,W 75-73,200,30,61,0.492,24,43,0.558,6,18,0.333,9,16,0.563,75
3/18/18,Florida State,Xavier,W 75-70,200,24,55,0.436,16,32,0.5,8,23,0.348,19,22,0.864,75
3/22/18,Florida State,Gonzaga,W 75-60,200,27,58,0.466,21,38,0.553,6,20,0.3,15,22,0.682,75
3/23/19,Kansas,Auburn,L 75-89,200,27,59,0.458,21,40,0.525,6,19,0.316,15,18,0.833,75
3/29/19,Duke,Virginia Tech,W 75-73,200,31,56,0.554,25,36,0.694,6,20,0.3,7,10,0.7,75
3/30/19,Texas Tech,Gonzaga,W 75-69,200,25,57,0.439,16,34,0.471,9,23,0.391,16,19,0.842,75
3/30/19,Purdue,Virginia,L 75-80 (OT),225,27,55,0.491,13,23,0.565,14,32,0.438,7,10,0.7,75
3/17/16,UConn,Colorado,W 74-67,200,23,58,0.397,17,41,0.415,6,17,0.353,22,23,0.957,74
3/17/16,Chattanooga,Indiana,L 74-99,200,28,59,0.475,25,42,0.595,3,17,0.176,15,18,0.833,74
3/18/16,S Dakota St.,Maryland,L 74-79,200,24,59,0.407,14,30,0.467,10,29,0.345,16,17,0.941,74
3/27/16,Notre Dame,UNC,L 74-88,200,27,49,0.551,18,31,0.581,9,18,0.5,11,14,0.786,74
4/4/16,UNC,Villanova,L 74-77,200,27,63,0.429,16,46,0.348,11,17,0.647,9,13,0.692,74
3/16/17,Virginia Tech,Wisconsin,L 74-84,200,23,49,0.469,16,32,0.5,7,17,0.412,21,26,0.808,74
3/18/17,Butler,Middle Tenn.,W 74-65,200,24,47,0.511,16,32,0.5,8,15,0.533,18,23,0.783,74
3/25/17,Oregon,Kansas,W 74-60,200,29,57,0.509,18,32,0.563,11,25,0.44,5,7,0.714,74
3/16/18,Purdue,Cal St Fullerton,W 74-48,200,23,59,0.39,14,37,0.378,9,22,0.409,19,27,0.704,74
3/16/18,UMBC,Virginia,W 74-54,200,26,48,0.542,14,24,0.583,12,24,0.5,10,14,0.714,74
3/20/19,N.C. Central,North Dakota St.,L 74-78,200,24,57,0.421,15,36,0.417,9,21,0.429,17,21,0.81,74
3/20/19,Arizona State,St. John's (NY),W 74-65,200,22,49,0.449,17,37,0.459,5,12,0.417,25,33,0.758,74
3/21/19,Yale,LSU,L 74-79,200,27,72,0.375,19,35,0.543,8,37,0.216,12,15,0.8,74
3/21/19,Michigan,Montana,W 74-55,200,25,51,0.49,20,34,0.588,5,17,0.294,19,24,0.792,74
3/22/19,Arizona State,Buffalo,L 74-91,200,26,60,0.433,23,38,0.605,3,22,0.136,19,20,0.95,74
3/24/19,Houston,Ohio State,W 74-59,200,26,56,0.464,21,37,0.568,5,19,0.263,17,25,0.68,74
3/19/16,Kansas,UConn,W 73-61,200,25,51,0.49,19,34,0.559,6,17,0.353,17,22,0.773,73
3/19/16,Indiana,Kentucky,W 73-67,200,25,52,0.481,19,31,0.613,6,21,0.286,17,23,0.739,73
3/20/16,Maryland,Hawaii,W 73-60,200,22,48,0.458,21,30,0.7,1,18,0.056,28,31,0.903,73
3/16/17,Nevada,Iowa State,L 73-84,200,26,65,0.4,18,39,0.462,8,26,0.308,13,16,0.813,73
3/17/17,New Mexico St.,Baylor,L 73-91,200,28,64,0.438,20,42,0.476,8,22,0.364,9,13,0.692,73
3/17/17,Marquette,South Carolina,L 73-93,200,25,54,0.463,14,26,0.538,11,28,0.393,12,14,0.857,73
3/18/17,Northwestern,Gonzaga,L 73-79,200,27,66,0.409,19,42,0.452,8,24,0.333,11,13,0.846,73
3/19/17,Michigan,Louisville,W 73-69,200,28,57,0.491,22,40,0.55,6,17,0.353,11,14,0.786,73
3/23/17,Xavier,Arizona,W 73-71,200,28,53,0.528,22,36,0.611,6,17,0.353,11,16,0.688,73
3/26/17,Kentucky,UNC,L 73-75,200,27,65,0.415,20,46,0.435,7,19,0.368,12,19,0.632,73
4/1/17,South Carolina,Gonzaga,L 73-77,200,25,66,0.379,18,46,0.391,7,20,0.35,16,22,0.727,73
3/15/18,Tennessee,Wright State,W 73-47,200,27,60,0.45,22,42,0.524,5,18,0.278,14,16,0.875,73
3/15/18,S Dakota St.,Ohio State,L 73-81,200,24,63,0.381,11,32,0.344,13,31,0.419,12,14,0.857,73
3/15/18,Davidson,Kentucky,L 73-78,200,24,61,0.393,13,28,0.464,11,33,0.333,14,17,0.824,73
3/16/18,Texas A&M,Providence,W 73-69,200,26,52,0.5,20,36,0.556,6,16,0.375,15,26,0.577,73
3/18/18,Butler,Purdue,L 73-76,200,27,55,0.491,21,35,0.6,6,20,0.3,13,14,0.929,73
3/18/18,Cincinnati,Nevada,L 73-75,200,27,66,0.409,22,49,0.449,5,17,0.294,14,17,0.824,73
3/22/19,Iona,UNC,L 73-88,200,22,55,0.4,7,14,0.5,15,41,0.366,14,15,0.933,73
3/22/19,UCF,VCU,W 73-58,200,28,57,0.491,19,43,0.442,9,14,0.643,8,11,0.727,73
3/24/19,Oregon,UC-Irvine,W 73-54,200,27,59,0.458,14,34,0.412,13,25,0.52,6,8,0.75,73
3/29/19,Virginia Tech,Duke,L 73-75,200,25,62,0.403,16,36,0.444,9,26,0.346,14,18,0.778,73
3/17/16,Buffalo,Miami (FL),L 72-79,200,23,59,0.39,13,33,0.394,10,26,0.385,16,22,0.727,72
3/18/16,Iowa,Temple,W 72-70 (OT),225,24,69,0.348,17,41,0.415,7,28,0.25,17,22,0.773,72
3/18/16,Texas,Northern Iowa,L 72-75,200,25,56,0.446,16,33,0.485,9,23,0.391,13,18,0.722,72
3/16/17,Minnesota,Middle Tenn.,L 72-81,200,24,52,0.462,18,31,0.581,6,21,0.286,18,21,0.857,72
3/17/17,Creighton,Rhode Island,L 72-84,200,26,65,0.4,19,42,0.452,7,23,0.304,13,19,0.684,72
3/19/17,UNC,Arkansas,W 72-65,200,24,63,0.381,19,46,0.413,5,17,0.294,19,25,0.76,72
3/19/17,Rhode Island,Oregon,L 72-75,200,30,59,0.508,24,37,0.649,6,22,0.273,6,8,0.75,72
3/22/18,Texas A&M,Michigan,L 72-99,200,32,67,0.478,29,52,0.558,3,15,0.2,5,10,0.5,72
3/22/19,Cincinnati,Iowa,L 72-79,200,28,65,0.431,22,38,0.579,6,27,0.222,10,14,0.714,72
3/22/19,Ole Miss,Oklahoma,L 72-95,200,29,62,0.468,18,31,0.581,11,31,0.355,3,4,0.75,72
3/22/19,Texas Tech,Northern Ky.,W 72-57,200,28,53,0.528,22,36,0.611,6,17,0.353,10,17,0.588,72
3/22/19,Oregon,Wisconsin,W 72-54,200,28,51,0.549,21,36,0.583,7,15,0.467,9,11,0.818,72
3/28/19,Gonzaga,Florida State,W 72-58,200,25,62,0.403,18,43,0.419,7,19,0.368,15,20,0.75,72
3/17/16,Butler,Texas Tech,W 71-61,200,25,51,0.49,16,34,0.471,9,17,0.529,12,16,0.75,71
3/18/16,Xavier,Weber State,W 71-53,200,30,62,0.484,23,48,0.479,7,14,0.5,4,4,1,71
3/19/16,Duke,Yale,W 71-64,200,23,50,0.46,12,27,0.444,11,23,0.478,14,16,0.875,71
3/25/16,Iowa State,Virginia,L 71-84,200,27,52,0.519,20,34,0.588,7,18,0.389,10,15,0.667,71
3/15/17,Providence,USC,L 71-75,200,25,51,0.49,16,31,0.516,9,20,0.45,12,17,0.706,71
3/16/17,UNC Wilmington,Virginia,L 71-76,200,25,61,0.41,15,35,0.429,10,26,0.385,11,17,0.647,71
3/17/17,Seton Hall,Arkansas,L 71-77,200,26,69,0.377,20,52,0.385,6,17,0.353,13,21,0.619,71
3/18/17,Notre Dame,West Virginia,L 71-83,200,22,54,0.407,12,26,0.462,10,28,0.357,17,17,1,71
3/23/17,Arizona,Xavier,L 71-73,200,27,62,0.435,20,35,0.571,7,27,0.259,10,11,0.909,71
4/3/17,UNC,Gonzaga,W 71-65,200,26,73,0.356,22,46,0.478,4,27,0.148,15,26,0.577,71
3/13/18,Radford,LIU,W 71-61,200,28,59,0.475,22,42,0.524,6,17,0.353,9,13,0.692,71
3/18/18,Marshall,West Virginia,L 71-94,200,22,56,0.393,10,30,0.333,12,26,0.462,15,21,0.714,71
3/25/18,Villanova,Texas Tech,W 71-59,200,19,57,0.333,15,33,0.455,4,24,0.167,29,35,0.829,71
3/22/19,Virginia,Gardner-Webb,W 71-56,200,28,54,0.519,21,31,0.677,7,23,0.304,8,13,0.615,71
3/23/19,Baylor,Gonzaga,L 71-83,200,25,60,0.417,21,39,0.538,4,21,0.19,17,22,0.773,71
3/31/19,Kentucky,Auburn,L 71-77 (OT),225,27,61,0.443,22,40,0.55,5,21,0.238,12,21,0.571,71
3/15/16,Wichita State,Vanderbilt,W 70-50,200,22,59,0.373,15,40,0.375,7,19,0.368,19,25,0.76,70
3/17/16,Providence,USC,W 70-69,200,25,62,0.403,16,38,0.421,9,24,0.375,11,14,0.786,70
3/18/16,Syracuse,Dayton,W 70-51,200,21,53,0.396,13,31,0.419,8,22,0.364,20,23,0.87,70
3/18/16,Temple,Iowa,L 70-72 (OT),225,30,66,0.455,26,48,0.542,4,18,0.222,6,9,0.667,70
3/18/16,Notre Dame,Michigan,W 70-63,200,25,43,0.581,17,28,0.607,8,15,0.533,12,15,0.8,70
3/18/16,Stephen F. Austin,West Virginia,W 70-56,200,17,55,0.309,10,32,0.313,7,23,0.304,29,39,0.744,70
3/16/17,Vermont,Purdue,L 70-80,200,27,61,0.443,17,34,0.5,10,27,0.37,6,10,0.6,70
3/17/17,Northern Ky.,Kentucky,L 70-79,200,26,73,0.356,18,41,0.439,8,32,0.25,10,11,0.909,70
3/19/17,Michigan State,Kansas,L 70-90,200,25,57,0.439,17,34,0.5,8,23,0.348,12,17,0.706,70
3/24/17,South Carolina,Baylor,W 70-50,200,23,50,0.46,15,30,0.5,8,20,0.4,16,23,0.696,70
3/26/17,Florida,South Carolina,L 70-77,200,25,60,0.417,18,34,0.529,7,26,0.269,13,14,0.929,70
3/15/18,Texas Tech,Stephen F. Austin,W 70-60,200,25,54,0.463,21,38,0.553,4,16,0.25,16,24,0.667,70
3/18/18,Xavier,Florida State,L 70-75,200,23,49,0.469,18,36,0.5,5,13,0.385,19,30,0.633,70
3/19/19,Temple,Belmont,L 70-81,200,28,71,0.394,21,49,0.429,7,22,0.318,7,13,0.538,70
3/21/19,Florida,Nevada,W 70-61,200,24,53,0.453,19,35,0.543,5,18,0.278,17,22,0.773,70
3/22/19,UC-Irvine,Kansas State,W 70-64,200,22,50,0.44,13,27,0.481,9,23,0.391,17,19,0.895,70
3/22/19,Colgate,Tennessee,L 70-77,200,25,56,0.446,10,27,0.37,15,29,0.517,5,6,0.833,70
3/23/19,Michigan State,Minnesota,W 70-50,200,28,49,0.571,22,34,0.647,6,15,0.4,8,11,0.727,70
3/17/16,USC,Providence,L 69-70,200,28,52,0.538,22,39,0.564,6,13,0.462,7,13,0.538,69
3/17/16,Fresno State,Utah,L 69-80,200,26,53,0.491,19,35,0.543,7,18,0.389,10,12,0.833,69
3/19/16,Butler,Virginia,L 69-77,200,25,54,0.463,18,39,0.462,7,15,0.467,12,17,0.706,69
3/20/16,Oregon,St. Joseph's,W 69-64,200,21,53,0.396,15,29,0.517,6,24,0.25,21,25,0.84,69
3/24/16,Miami (FL),Villanova,L 69-92,200,25,47,0.532,15,30,0.5,10,17,0.588,9,13,0.692,69
3/18/17,Arizona,Saint Mary's,W 69-60,200,23,51,0.451,19,40,0.475,4,11,0.364,19,23,0.826,69
3/19/17,Louisville,Michigan,L 69-73,200,28,61,0.459,23,41,0.561,5,20,0.25,8,12,0.667,69
3/23/17,Oregon,Michigan,W 69-68,200,26,58,0.448,18,41,0.439,8,17,0.471,9,16,0.563,69
3/16/18,Providence,Texas A&M,L 69-73,200,27,62,0.435,21,42,0.5,6,20,0.3,9,12,0.75,69
3/16/18,Kansas State,Creighton,W 69-59,200,23,50,0.46,14,31,0.452,9,19,0.474,14,25,0.56,69
3/17/18,Texas Tech,Florida,W 69-66,200,28,63,0.444,22,48,0.458,6,15,0.4,7,14,0.5,69
3/22/18,Loyola (IL),Nevada,W 69-68,200,29,52,0.558,24,39,0.615,5,13,0.385,6,8,0.75,69
3/23/18,Duke,Syracuse,W 69-65,200,22,56,0.393,17,30,0.567,5,26,0.192,20,28,0.714,69
3/31/18,Michigan,Loyola (IL),W 69-57,200,25,59,0.424,18,31,0.581,7,28,0.25,12,18,0.667,69
3/21/19,Vermont,Florida State,L 69-76,200,23,53,0.434,7,21,0.333,16,32,0.5,7,13,0.538,69
3/21/19,Syracuse,Baylor,L 69-78,200,21,51,0.412,9,22,0.409,12,29,0.414,15,18,0.833,69
3/23/19,LSU,Maryland,W 69-67,200,24,65,0.369,17,41,0.415,7,24,0.292,14,16,0.875,69
3/30/19,Gonzaga,Texas Tech,L 69-75,200,25,59,0.424,18,33,0.545,7,26,0.269,12,16,0.75,69
3/17/16,Gonzaga,Seton Hall,W 68-52,200,24,56,0.429,18,39,0.462,6,17,0.353,14,21,0.667,68
3/18/16,Cal St Bakersfield,Oklahoma,L 68-82,200,26,58,0.448,21,40,0.525,5,18,0.278,11,14,0.786,68
3/20/16,Iowa,Villanova,L 68-87,200,27,60,0.45,20,36,0.556,7,24,0.292,7,13,0.538,68
3/24/16,Duke,Oregon,L 68-82,200,26,59,0.441,19,37,0.514,7,22,0.318,9,15,0.6,68
3/26/16,Oregon,Oklahoma,L 68-80,200,21,54,0.389,17,33,0.515,4,21,0.19,22,30,0.733,68
3/27/16,Syracuse,Virginia,W 68-62,200,21,57,0.368,15,39,0.385,6,18,0.333,20,25,0.8,68
3/16/17,Northwestern,Vanderbilt,W 68-66,200,26,53,0.491,20,39,0.513,6,14,0.429,10,18,0.556,68
3/23/17,Michigan,Oregon,L 68-69,200,25,58,0.431,14,27,0.519,11,31,0.355,7,7,1,68
3/15/18,Gonzaga,UNC Greensboro,W 68-64,200,25,59,0.424,20,36,0.556,5,23,0.217,13,25,0.52,68
3/15/18,Arizona,Buffalo,L 68-89,200,29,64,0.453,27,46,0.587,2,18,0.111,8,11,0.727,68
3/16/18,Cincinnati,Georgia State,W 68-53,200,24,62,0.387,15,32,0.469,9,30,0.3,11,14,0.786,68
3/16/18,Murray State,West Virginia,L 68-85,200,21,51,0.412,14,28,0.5,7,23,0.304,19,23,0.826,68
3/16/18,New Mexico St.,Clemson,L 68-79,200,24,62,0.387,15,37,0.405,9,25,0.36,11,17,0.647,68
3/22/18,Nevada,Loyola (IL),L 68-69,200,24,58,0.414,17,31,0.548,7,27,0.259,13,14,0.929,68
3/21/19,Seton Hall,Wofford,L 68-84,200,25,62,0.403,16,35,0.457,9,27,0.333,9,15,0.6,68
3/31/19,Michigan State,Duke,W 68-67,200,30,70,0.429,24,51,0.471,6,19,0.316,2,6,0.333,68
3/16/16,Michigan,Tulsa,W 67-62,200,24,59,0.407,18,34,0.529,6,25,0.24,13,16,0.813,67
3/17/16,Colorado,UConn,L 67-74,200,23,51,0.451,21,41,0.512,2,10,0.2,19,30,0.633,67
3/17/16,Fla. Gulf Coast,UNC,L 67-83,200,25,58,0.431,23,47,0.489,2,11,0.182,15,24,0.625,67
3/18/16,Oregon State,VCU,L 67-75,200,25,60,0.417,18,43,0.419,7,17,0.412,10,15,0.667,67
3/19/16,Kentucky,Indiana,L 67-73,200,24,57,0.421,20,41,0.488,4,16,0.25,15,19,0.789,67
3/14/17,Mt. St. Mary's,New Orleans,W 67-66,200,25,47,0.532,15,28,0.536,10,19,0.526,7,13,0.538,67
3/15/17,UC-Davis,N.C. Central,W 67-63,200,22,48,0.458,17,32,0.531,5,16,0.313,18,22,0.818,67
3/19/17,Cincinnati,UCLA,L 67-79,200,26,58,0.448,19,38,0.5,7,20,0.35,8,10,0.8,67
3/15/18,Iona,Duke,L 67-89,200,26,60,0.433,21,36,0.583,5,24,0.208,10,14,0.714,67
3/15/18,Houston,San Diego State,W 67-65,200,22,59,0.373,17,46,0.37,5,13,0.385,18,24,0.75,67
3/16/18,Florida State,Missouri,W 67-54,199,21,49,0.429,14,34,0.412,7,15,0.467,18,31,0.581,67
3/23/19,Maryland,LSU,L 67-69,200,21,63,0.333,12,35,0.343,9,28,0.321,16,23,0.696,67
3/24/19,Virginia Tech,Liberty,W 67-58,200,24,57,0.421,17,41,0.415,7,16,0.438,12,16,0.75,67
3/31/19,Duke,Michigan State,L 67-68,200,26,57,0.456,19,36,0.528,7,21,0.333,8,13,0.615,67
3/18/16,California,Hawaii,L 66-77,200,23,56,0.411,20,37,0.541,3,19,0.158,17,26,0.654,66
3/19/16,Providence,UNC,L 66-85,200,23,57,0.404,17,34,0.5,6,23,0.261,14,23,0.609,66
3/20/16,Wisconsin,Xavier,W 66-63,200,25,59,0.424,17,32,0.531,8,27,0.296,8,13,0.615,66
4/2/16,Syracuse,UNC,L 66-83,200,27,66,0.409,19,41,0.463,8,25,0.32,4,13,0.308,66
3/14/17,New Orleans,Mt. St. Mary's,L 66-67,200,29,54,0.537,28,45,0.622,1,9,0.111,7,12,0.583,66
3/16/17,Gonzaga,S Dakota St.,W 66-46,200,25,63,0.397,17,33,0.515,8,30,0.267,8,18,0.444,66
3/16/17,Vanderbilt,Northwestern,L 66-68,200,21,55,0.382,12,29,0.414,9,26,0.346,15,18,0.833,66
3/17/17,USC,SMU,W 66-65,200,24,50,0.48,16,22,0.727,8,28,0.286,10,14,0.714,66
3/18/17,Florida State,Xavier,L 66-91,200,24,60,0.4,20,39,0.513,4,21,0.19,14,19,0.737,66
3/23/17,Purdue,Kansas,L 66-98,200,24,56,0.429,14,29,0.483,10,27,0.37,8,12,0.667,66
3/16/18,Lipscomb,UNC,L 66-84,200,23,64,0.359,16,36,0.444,7,28,0.25,13,15,0.867,66
3/17/18,Florida,Texas Tech,L 66-69,200,25,63,0.397,19,41,0.463,6,22,0.273,10,15,0.667,66
3/22/19,Virginia Tech,Saint Louis,W 66-52,200,20,48,0.417,16,38,0.421,4,10,0.4,22,27,0.815,66
3/15/16,Fairl. Dickinson,Fla. Gulf Coast,L 65-96,200,23,70,0.329,15,47,0.319,8,23,0.348,11,18,0.611,65
3/17/16,Wichita State,Arizona,W 65-55,200,24,59,0.407,21,39,0.538,3,20,0.15,14,19,0.737,65
3/18/16,Green Bay,Texas A&M,L 65-92,200,21,56,0.375,12,29,0.414,9,27,0.333,14,23,0.609,65
3/19/16,Miami (FL),Wichita State,W 65-57,200,21,38,0.553,14,26,0.538,7,12,0.583,16,23,0.696,65
3/16/17,ETSU,Florida,L 65-80,200,25,62,0.403,16,38,0.421,9,24,0.375,6,10,0.6,65
3/16/17,Maryland,Xavier,L 65-76,200,22,54,0.407,15,27,0.556,7,27,0.259,14,19,0.737,65
3/17/17,Troy,Duke,L 65-87,200,24,59,0.407,19,36,0.528,5,23,0.217,12,14,0.857,65
3/17/17,SMU,USC,L 65-66,200,24,57,0.421,15,34,0.441,9,23,0.391,8,11,0.727,65
3/18/17,Middle Tenn.,Butler,L 65-74,200,25,57,0.439,21,38,0.553,4,19,0.211,11,14,0.786,65
3/18/17,Florida,Virginia,W 65-39,200,23,50,0.46,15,29,0.517,8,21,0.381,11,18,0.611,65
3/18/17,Wisconsin,Villanova,W 65-62,200,26,49,0.531,20,31,0.645,6,18,0.333,7,16,0.438,65
3/19/17,Kentucky,Wichita State,W 65-62,200,23,55,0.418,16,37,0.432,7,18,0.389,12,18,0.667,65
3/19/17,Arkansas,UNC,L 65-72,200,26,60,0.433,18,39,0.462,8,21,0.381,5,8,0.625,65
4/3/17,Gonzaga,UNC,L 65-71,200,20,59,0.339,12,40,0.3,8,19,0.421,17,26,0.654,65
3/13/18,St. Bonaventure,UCLA,W 65-58,200,23,60,0.383,19,41,0.463,4,19,0.211,15,21,0.714,65
3/15/18,San Diego State,Houston,L 65-67,200,20,54,0.37,16,38,0.421,4,16,0.25,21,35,0.6,65
3/18/18,UNC,Texas A&M,L 65-86,200,26,78,0.333,20,47,0.426,6,31,0.194,7,7,1,65
3/23/18,Syracuse,Duke,L 65-69,200,25,51,0.49,21,38,0.553,4,13,0.308,11,17,0.647,65
3/23/18,Purdue,Texas Tech,L 65-78,200,26,58,0.448,19,40,0.475,7,18,0.389,6,6,1,65
3/20/19,St. John's (NY),Arizona State,L 65-74,200,22,69,0.319,14,38,0.368,8,31,0.258,13,23,0.565,65
3/21/19,Bradley,Michigan State,L 65-76,200,22,52,0.423,13,31,0.419,9,21,0.429,12,18,0.667,65
3/19/16,Yale,Duke,L 64-71,200,25,65,0.385,21,42,0.5,4,23,0.174,10,13,0.769,64
3/20/16,St. Joseph's,Oregon,L 64-69,200,22,57,0.386,18,42,0.429,4,15,0.267,16,20,0.8,64
3/26/16,Villanova,Kansas,W 64-59,200,21,52,0.404,17,34,0.5,4,18,0.222,18,19,0.947,64
3/16/17,Winthrop,Butler,L 64-76,200,25,62,0.403,16,37,0.432,9,25,0.36,5,10,0.5,64
3/17/17,Wichita State,Dayton,W 64-58,200,19,48,0.396,13,28,0.464,6,20,0.3,20,27,0.741,64
3/17/17,Texas Southern,UNC,L 64-103,200,22,60,0.367,15,33,0.455,7,27,0.259,13,16,0.813,64
3/14/18,Texas Southern,N.C. Central,W 64-46,200,21,57,0.368,15,33,0.455,6,24,0.25,16,19,0.842,64
3/15/18,UNC Greensboro,Gonzaga,L 64-68,200,28,67,0.418,25,45,0.556,3,22,0.136,5,10,0.5,64
3/15/18,Loyola (IL),Miami (FL),W 64-62,200,26,55,0.473,18,34,0.529,8,21,0.381,4,9,0.444,64
3/17/18,Michigan,Houston,W 64-63,200,21,59,0.356,13,29,0.448,8,30,0.267,14,20,0.7,64
3/21/19,Marquette,Murray State,L 64-83,200,24,74,0.324,16,43,0.372,8,31,0.258,8,12,0.667,64
3/22/19,Kansas State,UC-Irvine,L 64-70,200,22,59,0.373,14,32,0.438,8,27,0.296,12,15,0.8,64
3/23/19,Michigan,Florida,W 64-49,200,24,57,0.421,17,36,0.472,7,21,0.333,9,12,0.75,64
3/18/16,Michigan,Notre Dame,L 63-70,200,25,63,0.397,15,36,0.417,10,27,0.37,3,5,0.6,63
3/20/16,Xavier,Wisconsin,L 63-66,200,22,54,0.407,17,38,0.447,5,16,0.313,14,21,0.667,63
3/24/16,Maryland,Kansas,L 63-79,200,22,55,0.4,17,30,0.567,5,25,0.2,14,20,0.7,63
3/24/16,Texas A&M,Oklahoma,L 63-77,200,22,64,0.344,16,36,0.444,6,28,0.214,13,24,0.542,63
3/25/16,Syracuse,Gonzaga,W 63-60,200,22,61,0.361,17,46,0.37,5,15,0.333,14,16,0.875,63
3/15/17,N.C. Central,UC-Davis,L 63-67,200,24,67,0.358,19,41,0.463,5,26,0.192,10,13,0.769,63
3/17/17,Jacksonville St.,Louisville,L 63-78,200,23,46,0.5,13,27,0.481,10,19,0.526,7,8,0.875,63
3/17/18,Loyola (IL),Tennessee,W 63-62,200,22,44,0.5,14,24,0.583,8,20,0.4,11,16,0.688,63
3/17/18,Houston,Michigan,L 63-64,200,20,54,0.37,13,36,0.361,7,18,0.389,16,22,0.727,63
3/24/19,Virginia,Oklahoma,W 63-51,200,27,56,0.482,20,32,0.625,7,24,0.292,2,5,0.4,63
3/28/19,Texas Tech,Michigan,W 63-44,200,24,55,0.436,18,36,0.5,6,19,0.316,9,10,0.9,63
3/29/19,LSU,Michigan State,L 63-80,200,24,61,0.393,18,40,0.45,6,21,0.286,9,14,0.643,63
4/6/19,Virginia,Auburn,W 63-62,200,25,51,0.49,18,32,0.563,7,19,0.368,6,12,0.5,63
3/16/16,Tulsa,Michigan,L 62-67,200,25,56,0.446,22,41,0.537,3,15,0.2,9,15,0.6,62
3/27/16,Virginia,Syracuse,L 62-68,200,22,53,0.415,14,32,0.438,8,21,0.381,10,12,0.833,62
3/17/17,UC-Davis,Kansas,L 62-100,200,21,62,0.339,17,42,0.405,4,20,0.2,16,18,0.889,62
3/18/17,Villanova,Wisconsin,L 62-65,200,21,51,0.412,16,35,0.457,5,16,0.313,15,21,0.714,62
3/19/17,Wichita State,Kentucky,L 62-65,200,24,62,0.387,16,38,0.421,8,24,0.333,6,9,0.667,62
3/15/18,Miami (FL),Loyola (IL),L 62-64,200,25,49,0.51,21,40,0.525,4,9,0.444,8,13,0.615,62
3/15/18,St. Bonaventure,Florida,L 62-77,199,17,48,0.354,14,29,0.483,3,19,0.158,25,34,0.735,62
3/16/18,Arkansas,Butler,L 62-79,200,20,56,0.357,16,38,0.421,4,18,0.222,18,23,0.783,62
3/16/18,Auburn,Charleston,W 62-58,200,21,59,0.356,16,35,0.457,5,24,0.208,15,32,0.469,62
3/17/18,Rhode Island,Duke,L 62-87,200,25,63,0.397,18,44,0.409,7,19,0.368,5,13,0.385,62
3/17/18,Tennessee,Loyola (IL),L 62-63,200,25,55,0.455,16,30,0.533,9,25,0.36,3,6,0.5,62
3/24/18,Kansas State,Loyola (IL),L 62-78,200,23,66,0.348,17,40,0.425,6,26,0.231,10,12,0.833,62
4/2/18,Michigan,Villanova,L 62-79,200,24,55,0.436,21,32,0.656,3,23,0.13,11,18,0.611,62
3/22/19,North Dakota St.,Duke,L 62-85,200,21,58,0.362,13,29,0.448,8,29,0.276,12,14,0.857,62
3/22/19,Ohio State,Iowa State,W 62-59,200,23,58,0.397,18,38,0.474,5,20,0.25,11,14,0.786,62
3/23/19,Kentucky,Wofford,W 62-56,200,21,52,0.404,18,39,0.462,3,13,0.231,17,20,0.85,62
3/23/19,Murray State,Florida State,L 62-90,200,20,61,0.328,13,43,0.302,7,18,0.389,15,21,0.714,62
3/29/19,Kentucky,Houston,W 62-58,200,22,46,0.478,18,34,0.529,4,12,0.333,14,19,0.737,62
4/6/19,Auburn,Virginia,L 62-63,200,21,55,0.382,12,24,0.5,9,31,0.29,11,14,0.786,62
3/17/16,Texas Tech,Butler,L 61-71,200,25,54,0.463,18,36,0.5,7,18,0.389,4,9,0.444,61
3/19/16,Little Rock,Iowa State,L 61-78,200,20,54,0.37,12,29,0.414,8,25,0.32,13,16,0.813,61
3/19/16,UConn,Kansas,L 61-73,200,21,62,0.339,11,40,0.275,10,22,0.455,9,11,0.818,61
3/25/16,Notre Dame,Wisconsin,W 61-56,200,22,55,0.4,18,42,0.429,4,13,0.308,13,14,0.929,61
3/17/17,Kansas State,Cincinnati,L 61-75,200,21,54,0.389,14,36,0.389,7,18,0.389,12,15,0.8,61
3/23/17,Gonzaga,West Virginia,W 61-58,200,18,44,0.409,14,34,0.412,4,10,0.4,21,32,0.656,61
3/13/18,LIU,Radford,L 61-71,200,19,50,0.38,12,24,0.5,7,26,0.269,16,23,0.696,61
3/15/18,Radford,Villanova,L 61-87,200,20,59,0.339,12,35,0.343,8,24,0.333,13,16,0.813,61
3/15/18,Michigan,Montana,W 61-47,200,21,47,0.447,16,31,0.516,5,16,0.313,14,22,0.636,61
3/22/18,Kansas State,Kentucky,W 61-58,200,19,54,0.352,10,32,0.313,9,22,0.409,14,22,0.636,61
3/21/19,Nevada,Florida,L 61-70,200,19,55,0.345,14,31,0.452,5,24,0.208,18,25,0.72,61
3/21/19,Villanova,Saint Mary's,W 61-57,200,24,49,0.49,16,29,0.552,8,20,0.4,5,9,0.556,61
3/21/19,Purdue,Old Dominion,W 61-48,200,20,53,0.377,11,23,0.478,9,30,0.3,12,18,0.667,61
3/22/19,Utah State,Washington,L 61-78,200,19,54,0.352,12,34,0.353,7,20,0.35,16,20,0.8,61
3/23/19,Villanova,Purdue,L 61-87,200,20,58,0.345,9,20,0.45,11,38,0.289,10,11,0.909,61
4/6/19,Texas Tech,Michigan State,W 61-51,202,22,51,0.431,13,28,0.464,9,23,0.391,8,13,0.615,61
3/20/16,Hawaii,Maryland,L 60-73,200,23,70,0.329,19,51,0.373,4,19,0.211,10,15,0.667,60
3/25/16,Gonzaga,Syracuse,L 60-63,200,24,55,0.436,16,34,0.471,8,21,0.381,4,5,0.8,60
3/16/17,Notre Dame,Princeton,W 60-58,200,21,52,0.404,17,41,0.415,4,11,0.364,14,21,0.667,60
3/18/17,Saint Mary's,Arizona,L 60-69,200,25,54,0.463,20,33,0.606,5,21,0.238,5,8,0.625,60
3/25/17,Kansas,Oregon,L 60-74,200,21,60,0.35,16,35,0.457,5,25,0.2,13,17,0.765,60
3/14/18,Syracuse,Arizona State,W 60-56,200,20,49,0.408,13,29,0.448,7,20,0.35,13,23,0.565,60
3/15/18,Penn,Kansas,L 60-76,200,22,56,0.393,11,27,0.407,11,29,0.379,5,14,0.357,60
3/15/18,Stephen F. Austin,Texas Tech,L 60-70,200,18,47,0.383,13,33,0.394,5,14,0.357,19,28,0.679,60
3/22/18,Gonzaga,Florida State,L 60-75,200,20,59,0.339,15,39,0.385,5,20,0.25,15,24,0.625,60
3/16/16,Holy Cross,Southern,W 59-55,200,18,40,0.45,9,15,0.6,9,25,0.36,14,19,0.737,59
3/19/16,Utah,Gonzaga,L 59-82,200,22,52,0.423,15,37,0.405,7,15,0.467,8,8,1,59
3/26/16,Kansas,Villanova,L 59-64,200,23,50,0.46,17,28,0.607,6,22,0.273,7,11,0.636,59
3/25/17,Xavier,Gonzaga,L 59-83,200,22,62,0.355,20,46,0.435,2,16,0.125,13,22,0.591,59
3/16/18,Creighton,Kansas State,L 59-69,200,23,68,0.338,14,34,0.412,9,34,0.265,4,5,0.8,59
3/25/18,Texas Tech,Villanova,L 59-71,200,20,60,0.333,15,40,0.375,5,20,0.25,14,18,0.778,59
3/22/19,Iowa State,Ohio State,L 59-62,200,23,53,0.434,17,31,0.548,6,22,0.273,7,10,0.7,59
3/24/19,Washington,UNC,L 59-81,200,23,60,0.383,14,31,0.452,9,29,0.31,4,10,0.4,59
3/24/19,Ohio State,Houston,L 59-74,200,19,49,0.388,9,20,0.45,10,29,0.345,11,16,0.688,59
3/16/17,Princeton,Notre Dame,L 58-60,200,22,57,0.386,14,26,0.538,8,31,0.258,6,6,1,58
3/17/17,Dayton,Wichita State,L 58-64,200,18,58,0.31,11,36,0.306,7,22,0.318,15,20,0.75,58
3/17/17,Miami (FL),Michigan State,L 58-78,200,21,52,0.404,17,36,0.472,4,16,0.25,12,17,0.706,58
3/23/17,West Virginia,Gonzaga,L 58-61,200,16,60,0.267,11,37,0.297,5,23,0.217,21,29,0.724,58
3/13/18,UCLA,St. Bonaventure,L 58-65,200,21,50,0.42,11,20,0.55,10,30,0.333,6,10,0.6,58
3/16/18,Charleston,Auburn,L 58-62,200,23,51,0.451,18,29,0.621,5,22,0.227,7,14,0.5,58
3/17/18,Alabama,Villanova,L 58-81,200,20,48,0.417,16,32,0.5,4,16,0.25,14,23,0.609,58
3/22/18,Kentucky,Kansas State,L 58-61,200,16,42,0.381,13,30,0.433,3,12,0.25,23,37,0.622,58
3/24/18,Michigan,Florida State,W 58-54,200,19,49,0.388,15,27,0.556,4,22,0.182,16,24,0.667,58
3/22/19,VCU,UCF,L 58-73,200,19,61,0.311,13,35,0.371,6,26,0.231,14,17,0.824,58
3/24/19,Buffalo,Texas Tech,L 58-78,200,19,52,0.365,10,25,0.4,9,27,0.333,11,22,0.5,58
3/24/19,Liberty,Virginia Tech,L 58-67,200,18,47,0.383,8,16,0.5,10,31,0.323,12,14,0.857,58
3/28/19,Florida State,Gonzaga,L 58-72,200,24,61,0.393,21,41,0.512,3,20,0.15,7,11,0.636,58
3/29/19,Houston,Kentucky,L 58-62,200,21,53,0.396,14,33,0.424,7,20,0.35,9,12,0.75,58
3/17/16,Stony Brook,Kentucky,L 57-85,200,20,76,0.263,17,63,0.27,3,13,0.231,14,18,0.778,57
3/19/16,Wichita State,Miami (FL),L 57-65,200,20,59,0.339,14,37,0.378,6,22,0.273,11,14,0.786,57
3/16/18,Syracuse,TCU,W 57-52,200,21,57,0.368,18,43,0.419,3,14,0.214,12,15,0.8,57
3/31/18,Loyola (IL),Michigan,L 57-69,200,22,51,0.431,21,41,0.512,1,10,0.1,12,14,0.857,57
3/21/19,Saint Mary's,Villanova,L 57-61,200,23,55,0.418,15,33,0.455,8,22,0.364,3,6,0.5,57
3/22/19,Northern Ky.,Texas Tech,L 57-72,200,23,62,0.371,18,40,0.45,5,22,0.227,6,8,0.75,57
3/18/16,UNC Asheville,Villanova,L 56-86,200,21,57,0.368,16,40,0.4,5,17,0.294,9,13,0.692,56
3/18/16,West Virginia,Stephen F. Austin,L 56-70,200,16,52,0.308,13,36,0.361,3,16,0.188,21,27,0.778,56
3/25/16,Wisconsin,Notre Dame,L 56-61,200,23,57,0.404,17,37,0.459,6,20,0.3,4,6,0.667,56
3/16/17,Mt. St. Mary's,Villanova,L 56-76,200,21,57,0.368,16,36,0.444,5,21,0.238,9,12,0.75,56
3/14/18,Arizona State,Syracuse,L 56-60,200,21,52,0.404,10,20,0.5,11,32,0.344,3,10,0.3,56
3/22/19,Gardner-Webb,Virginia,L 56-71,200,22,50,0.44,13,27,0.481,9,23,0.391,3,4,0.75,56
3/23/19,Wofford,Kentucky,L 56-62,200,21,56,0.375,13,29,0.448,8,27,0.296,6,9,0.667,56
3/16/16,Southern,Holy Cross,L 55-59,200,22,56,0.393,19,36,0.528,3,20,0.15,8,11,0.727,55
3/17/16,Arizona,Wichita State,L 55-65,200,20,48,0.417,14,30,0.467,6,18,0.333,9,15,0.6,55
3/18/18,Syracuse,Michigan State,W 55-53,200,15,42,0.357,14,34,0.412,1,8,0.125,24,31,0.774,55
3/21/19,Montana,Michigan,L 55-74,200,20,60,0.333,14,36,0.389,6,24,0.25,9,13,0.692,55
3/22/19,Georgia State,Houston,L 55-84,200,18,60,0.3,12,37,0.324,6,23,0.261,13,17,0.765,55
3/16/18,Missouri,Florida State,L 54-67,201,16,49,0.327,8,25,0.32,8,24,0.333,14,21,0.667,54
3/16/18,Virginia,UMBC,L 54-74,200,23,56,0.411,19,34,0.559,4,22,0.182,4,8,0.5,54
3/24/18,Florida State,Michigan,L 54-58,200,16,51,0.314,12,34,0.353,4,17,0.235,18,20,0.9,54
3/22/19,Wisconsin,Oregon,L 54-72,200,20,60,0.333,14,30,0.467,6,30,0.2,8,13,0.615,54
3/24/19,UC-Irvine,Oregon,L 54-73,200,20,51,0.392,15,33,0.455,5,18,0.278,9,13,0.692,54
3/18/16,Weber State,Xavier,L 53-71,200,22,57,0.386,18,36,0.5,4,21,0.19,5,11,0.455,53
3/16/18,Georgia State,Cincinnati,L 53-68,200,21,53,0.396,13,26,0.5,8,27,0.296,3,3,1,53
3/18/18,Michigan State,Syracuse,L 53-55,200,17,66,0.258,9,29,0.31,8,37,0.216,11,16,0.688,53
3/18/18,Auburn,Clemson,L 53-84,200,17,66,0.258,10,34,0.294,7,32,0.219,12,15,0.8,53
3/21/19,Northeastern,Kansas,L 53-87,200,16,57,0.281,10,29,0.345,6,28,0.214,15,20,0.75,53
3/28/19,Virginia,Oregon,W 53-49,200,20,56,0.357,11,23,0.478,9,33,0.273,4,5,0.8,53
3/17/16,Seton Hall,Gonzaga,L 52-68,200,20,62,0.323,16,41,0.39,4,21,0.19,8,21,0.381,52
3/18/16,Holy Cross,Oregon,L 52-91,200,20,55,0.364,14,32,0.438,6,23,0.261,6,15,0.4,52
3/16/18,TCU,Syracuse,L 52-57,200,19,48,0.396,16,31,0.516,3,17,0.176,11,17,0.647,52
3/22/19,Saint Louis,Virginia Tech,L 52-66,200,19,52,0.365,15,29,0.517,4,23,0.174,10,16,0.625,52
3/18/16,Dayton,Syracuse,L 51-70,200,18,56,0.321,12,34,0.353,6,22,0.273,9,19,0.474,51
4/2/16,Oklahoma,Villanova,L 51-95,200,19,60,0.317,13,33,0.394,6,27,0.222,7,11,0.636,51
3/24/19,Oklahoma,Virginia,L 51-63,200,19,52,0.365,11,30,0.367,8,22,0.364,5,6,0.833,51
4/6/19,Michigan State,Texas Tech,L 51-61,200,15,47,0.319,8,23,0.348,7,24,0.292,14,18,0.778,51
3/15/16,Vanderbilt,Wichita State,L 50-70,200,16,53,0.302,13,34,0.382,3,19,0.158,15,26,0.577,50
3/20/16,Middle Tenn.,Syracuse,L 50-75,200,19,64,0.297,11,40,0.275,8,24,0.333,4,8,0.5,50
3/24/17,Baylor,South Carolina,L 50-70,200,17,56,0.304,14,43,0.326,3,13,0.231,13,20,0.65,50
3/18/18,Kansas State,UMBC,W 50-43,200,18,44,0.409,17,32,0.531,1,12,0.083,13,18,0.722,50
3/23/19,Minnesota,Michigan State,L 50-70,200,18,59,0.305,16,37,0.432,2,22,0.091,12,14,0.857,50
3/21/19,Fairl. Dickinson,Gonzaga,L 49-87,200,15,50,0.3,9,29,0.31,6,21,0.286,13,23,0.565,49
3/23/19,Florida,Michigan,L 49-64,200,19,55,0.345,10,29,0.345,9,26,0.346,2,2,1,49
3/28/19,Oregon,Virginia,L 49-53,200,17,45,0.378,8,20,0.4,9,25,0.36,6,8,0.75,49
3/16/18,Cal St Fullerton,Purdue,L 48-74,200,18,50,0.36,14,32,0.438,4,18,0.222,8,16,0.5,48
3/21/19,Old Dominion,Purdue,L 48-61,200,18,67,0.269,12,42,0.286,6,25,0.24,6,6,1,48
3/18/16,Wisconsin,Pitt,W 47-43,200,17,53,0.321,13,34,0.382,4,19,0.211,9,15,0.6,47
3/15/18,Wright State,Tennessee,L 47-73,200,19,60,0.317,15,39,0.385,4,21,0.19,5,9,0.556,47
3/15/18,Montana,Michigan,L 47-61,200,18,56,0.321,15,41,0.366,3,15,0.2,8,11,0.727,47
3/16/17,S Dakota St.,Gonzaga,L 46-66,200,18,58,0.31,13,38,0.342,5,20,0.25,5,11,0.455,46
3/14/18,N.C. Central,Texas Southern,L 46-64,200,21,69,0.304,21,55,0.382,0,14,0,4,6,0.667,46
3/17/16,Hampton,Virginia,L 45-81,200,17,56,0.304,14,37,0.378,3,19,0.158,8,10,0.8,45
3/21/19,Abilene Christ.,Kentucky,L 44-79,200,17,53,0.321,12,30,0.4,5,23,0.217,5,10,0.5,44
3/28/19,Michigan,Texas Tech,L 44-63,200,16,49,0.327,15,30,0.5,1,19,0.053,11,17,0.647,44
3/18/16,Pitt,Wisconsin,L 43-47,200,18,48,0.375,15,37,0.405,3,11,0.273,4,7,0.571,43
3/18/18,UMBC,Kansas State,L 43-50,200,14,47,0.298,8,25,0.32,6,22,0.273,9,18,0.5,43
3/18/17,Virginia,Florida,L 39-65,200,16,54,0.296,15,39,0.385,1,15,0.067,6,7,0.857,39
3/18/11,UNC,LIU,W 102-87,200,34,67,0.507,31,50,0.62,3,17,0.176,31,42,0.738,102
3/23/12,Kentucky,Indiana,W 102-90,200,31,64,0.484,26,54,0.481,5,10,0.5,35,37,0.946,102
3/20/11,Ohio State,George Mason,W 98-66,200,36,59,0.61,20,33,0.606,16,26,0.615,10,18,0.556,98
3/22/13,Ohio State,Iona,W 95-70,200,34,71,0.479,27,56,0.482,7,15,0.467,20,25,0.8,95
3/20/11,VCU,Purdue,W 94-76,200,37,65,0.569,29,44,0.659,8,21,0.381,12,14,0.857,94
3/17/15,Ole Miss,BYU,W 94-90,200,36,80,0.45,29,57,0.509,7,23,0.304,15,23,0.652,94
3/24/11,Arizona,Duke,W 93-77,200,34,63,0.54,25,48,0.521,9,15,0.6,16,21,0.762,93
3/20/14,Michigan State,Delaware,W 93-78,200,30,56,0.536,20,37,0.541,10,19,0.526,23,25,0.92,93
3/21/14,Iowa State,N.C. Central,W 93-75,200,35,55,0.636,26,38,0.684,9,17,0.529,14,16,0.875,93
3/19/15,Arizona,Texas Southern,W 93-72,200,32,53,0.604,27,42,0.643,5,11,0.455,24,27,0.889,93
3/19/15,Villanova,Lafayette,W 93-52,200,36,57,0.632,25,35,0.714,11,22,0.5,10,15,0.667,93
3/21/15,UCLA,UAB,W 92-75,200,35,58,0.603,30,49,0.612,5,9,0.556,17,25,0.68,92
3/23/12,Indiana,Kentucky,L 90-102,200,36,69,0.522,31,51,0.608,5,18,0.278,13,17,0.765,90
3/17/15,BYU,Ole Miss,L 90-94,200,28,58,0.483,13,29,0.448,15,29,0.517,19,27,0.704,90
3/19/11,BYU,Gonzaga,W 89-67,200,31,59,0.525,17,31,0.548,14,28,0.5,13,15,0.867,89
3/16/12,Michigan State,LIU,W 89-67,200,40,68,0.588,37,59,0.627,3,9,0.333,6,9,0.667,89
3/20/14,UConn,St. Joseph's,W 89-81 (OT),225,30,66,0.455,19,42,0.452,11,24,0.458,18,20,0.9,89
3/15/12,Marquette,BYU,W 88-68,200,30,66,0.455,21,46,0.457,9,20,0.45,19,26,0.731,88
3/21/13,VCU,Akron,W 88-42,200,35,65,0.538,27,49,0.551,8,16,0.5,10,14,0.714,88
3/18/11,Duke,Hampton,W 87-45,200,32,60,0.533,23,41,0.561,9,19,0.474,14,16,0.875,87
3/18/11,LIU,UNC,L 87-102,200,31,85,0.365,23,54,0.426,8,31,0.258,17,25,0.68,87
3/17/12,Kentucky,Iowa State,W 87-71,200,31,56,0.554,21,36,0.583,10,20,0.5,15,22,0.682,87
3/18/12,UNC,Creighton,W 87-73,200,33,65,0.508,25,49,0.51,8,16,0.5,13,19,0.684,87
3/29/13,Michigan,Kansas,W 87-85 (OT),225,35,71,0.493,27,48,0.563,8,23,0.348,9,17,0.529,87
3/20/14,Texas,Arizona State,W 87-85,200,31,58,0.534,26,46,0.565,5,12,0.417,20,27,0.741,87
3/20/14,Oregon,BYU,W 87-68,200,27,54,0.5,25,41,0.61,2,13,0.154,31,38,0.816,87
3/21/15,UNC,Arkansas,W 87-78,200,27,60,0.45,23,50,0.46,4,10,0.4,29,37,0.784,87
3/22/15,Gonzaga,Iowa,W 87-68,200,32,52,0.615,22,36,0.611,10,16,0.625,13,21,0.619,87
3/17/11,Gonzaga,St. John's (NY),W 86-71,200,28,52,0.538,19,37,0.514,9,15,0.6,21,26,0.808,86
3/20/11,UNC,Washington,W 86-83,200,31,66,0.47,25,54,0.463,6,12,0.5,18,23,0.783,86
3/16/12,Norfolk State,Missouri,W 86-84,200,32,59,0.542,22,40,0.55,10,19,0.526,12,18,0.667,86
3/21/14,Tennessee,UMass,W 86-67,199,30,56,0.536,28,42,0.667,2,14,0.143,24,31,0.774,86
3/20/15,Wisconsin,Coastal Caro.,W 86-72,200,33,61,0.541,22,34,0.647,11,27,0.407,9,12,0.75,86
3/20/15,Gonzaga,North Dakota St.,W 86-76,200,30,58,0.517,23,36,0.639,7,22,0.318,19,28,0.679,86
3/18/11,Texas,Oakland,W 85-81,200,30,63,0.476,26,54,0.481,4,9,0.444,21,26,0.808,85
3/29/13,Kansas,Michigan,L 85-87 (OT),225,36,66,0.545,30,50,0.6,6,16,0.375,7,10,0.7,85
3/31/13,Louisville,Duke,W 85-63,200,29,55,0.527,27,42,0.643,2,13,0.154,25,36,0.694,85
3/20/14,Arizona State,Texas,L 85-87,200,27,56,0.482,19,41,0.463,8,15,0.533,23,33,0.697,85
3/21/14,Gonzaga,Oklahoma State,W 85-77,200,25,50,0.5,16,32,0.5,9,18,0.5,26,41,0.634,85
3/22/14,Wisconsin,Oregon,W 85-77,200,29,60,0.483,18,32,0.563,11,28,0.393,16,25,0.64,85
3/23/14,Baylor,Creighton,W 85-55,200,30,47,0.638,19,29,0.655,11,18,0.611,14,21,0.667,85
3/23/14,Iowa State,UNC,W 85-83,200,29,66,0.439,17,40,0.425,12,26,0.462,15,21,0.714,85
3/20/15,Duke,Robert Morris,W 85-56,200,34,54,0.63,24,33,0.727,10,21,0.476,7,14,0.5,85
3/28/15,Wisconsin,Arizona,W 85-78,200,25,45,0.556,13,27,0.481,12,18,0.667,23,31,0.742,85
3/17/11,West Virginia,Clemson,W 84-76,200,27,55,0.491,22,42,0.524,5,13,0.385,25,31,0.806,84
3/16/12,Missouri,Norfolk State,L 84-86,200,29,55,0.527,16,26,0.615,13,29,0.448,13,17,0.765,84
3/18/12,Florida,Norfolk State,W 84-50,200,28,53,0.528,18,25,0.72,10,28,0.357,18,25,0.72,84
3/21/13,Colorado State,Missouri,W 84-72,200,25,51,0.49,18,37,0.486,7,14,0.5,27,33,0.818,84
3/23/14,Arizona,Gonzaga,W 84-61,200,32,65,0.492,25,47,0.532,7,18,0.389,13,18,0.722,84
3/19/15,Georgetown,Eastern Wash.,W 84-74,200,25,48,0.521,14,25,0.56,11,23,0.478,23,32,0.719,84
3/20/11,Washington,UNC,L 83-86,200,33,72,0.458,23,53,0.434,10,19,0.526,7,7,1,83
3/24/11,Florida,BYU,W 83-74 (OT),225,31,65,0.477,20,31,0.645,11,34,0.324,10,22,0.455,83
3/22/13,Indiana,James Madison,W 83-62,200,29,55,0.527,20,32,0.625,9,23,0.391,16,21,0.762,83
3/22/13,Minnesota,UCLA,W 83-63,200,31,61,0.508,22,45,0.489,9,16,0.563,12,19,0.632,83
3/20/14,Saint Louis,NC State,W 83-80 (OT),225,31,64,0.484,22,46,0.478,9,18,0.5,12,26,0.462,83
3/23/14,UNC,Iowa State,L 83-85,200,33,70,0.471,25,50,0.5,8,20,0.4,9,15,0.6,83
3/23/14,Tennessee,Mercer,W 83-63,200,27,55,0.491,21,33,0.636,6,22,0.273,23,26,0.885,83
3/20/15,Iowa,Davidson,W 83-52,200,35,69,0.507,29,53,0.547,6,16,0.375,7,10,0.7,83
3/25/12,Kentucky,Baylor,W 82-70,200,24,45,0.533,20,36,0.556,4,9,0.444,30,44,0.682,82
3/23/13,Louisville,Colorado State,W 82-56,200,31,55,0.564,26,46,0.565,5,9,0.556,15,18,0.833,82
4/8/13,Louisville,Michigan,W 82-76,200,28,61,0.459,20,45,0.444,8,16,0.5,18,23,0.783,82
3/27/14,Dayton,Stanford,W 82-72,200,28,58,0.483,20,35,0.571,8,23,0.348,18,26,0.692,82
3/15/11,UNC Asheville,Little Rock,W 81-77 (OT),225,27,54,0.5,23,42,0.548,4,12,0.333,23,28,0.821,81
3/17/11,UConn,Bucknell,W 81-52,200,32,66,0.485,23,42,0.548,9,24,0.375,8,9,0.889,81
3/18/11,Oakland,Texas,L 81-85,200,33,75,0.44,26,46,0.565,7,29,0.241,8,11,0.727,81
3/25/11,UNC,Marquette,W 81-63,200,31,74,0.419,26,58,0.448,5,16,0.313,14,21,0.667,81
3/15/12,Kentucky,Western Ky.,W 81-66,200,30,54,0.556,27,44,0.614,3,10,0.3,18,25,0.72,81
3/22/12,Ohio State,Cincinnati,W 81-66,200,27,56,0.482,19,39,0.487,8,17,0.471,19,27,0.704,81
3/21/13,Arizona,Belmont,W 81-64,200,29,51,0.569,20,34,0.588,9,17,0.529,14,20,0.7,81
3/21/13,Syracuse,Montana,W 81-34,200,27,52,0.519,22,41,0.537,5,11,0.455,22,31,0.71,81
3/24/13,Fla. Gulf Coast,San Diego State,W 81-71,200,33,59,0.559,26,41,0.634,7,18,0.389,8,12,0.667,81
3/19/14,Cal Poly,Texas Southern,W 81-69,200,29,51,0.569,23,36,0.639,6,15,0.4,17,22,0.773,81
3/20/14,St. Joseph's,UConn,L 81-89 (OT),225,27,54,0.5,20,33,0.606,7,21,0.333,20,27,0.741,81
3/28/14,UConn,Iowa State,W 81-76,200,26,50,0.52,17,31,0.548,9,19,0.474,20,22,0.909,81
3/18/15,Robert Morris,North Florida,W 81-77,200,28,62,0.452,24,46,0.522,4,16,0.25,21,33,0.636,81
3/20/15,Wichita State,Indiana,W 81-76,200,25,61,0.41,23,48,0.479,2,13,0.154,29,34,0.853,81
3/26/15,Notre Dame,Wichita State,W 81-70,200,30,54,0.556,21,35,0.6,9,19,0.474,12,15,0.8,81
4/4/15,Duke,Michigan State,W 81-61,200,26,50,0.52,24,40,0.6,2,10,0.2,27,37,0.73,81
3/17/12,Baylor,Colorado,W 80-63,200,28,64,0.438,17,44,0.386,11,20,0.55,13,18,0.722,80
3/25/12,Kansas,UNC,W 80-67,200,29,63,0.46,25,49,0.51,4,14,0.286,18,24,0.75,80
3/20/13,La Salle,Boise State,W 80-71,200,31,49,0.633,20,28,0.714,11,21,0.524,7,12,0.583,80
3/20/14,NC State,Saint Louis,L 80-83 (OT),225,28,60,0.467,24,51,0.471,4,9,0.444,20,37,0.541,80
3/20/14,North Dakota St.,Oklahoma,W 80-75 (OT),225,27,51,0.529,21,37,0.568,6,14,0.429,20,22,0.909,80
3/21/14,Kansas,Eastern Ky.,W 80-69,200,32,53,0.604,32,46,0.696,0,7,0,16,24,0.667,80
3/22/14,Michigan State,Harvard,W 80-73,200,28,57,0.491,21,36,0.583,7,21,0.333,17,22,0.773,80
3/17/11,Florida,UCSB,W 79-51,200,29,53,0.547,21,30,0.7,8,23,0.348,13,17,0.765,79
3/15/12,Vanderbilt,Harvard,W 79-70,200,25,46,0.543,17,28,0.607,8,18,0.444,21,30,0.7,79
3/15/12,Indiana,New Mexico St.,W 79-66,200,32,54,0.593,25,41,0.61,7,13,0.538,8,10,0.8,79
3/16/12,NC State,San Diego State,W 79-65,200,31,53,0.585,28,44,0.636,3,9,0.333,14,21,0.667,79
3/21/13,Louisville,N.C. A&T,W 79-48,200,31,54,0.574,27,38,0.711,4,16,0.25,13,22,0.591,79
3/22/13,Florida,NW St.,W 79-47,200,29,61,0.475,22,40,0.55,7,21,0.333,14,23,0.609,79
3/31/13,Michigan,Florida,W 79-59,200,30,65,0.462,20,46,0.435,10,19,0.526,9,13,0.692,79
3/21/14,UNC,Providence,W 79-77,200,33,71,0.465,29,56,0.518,4,15,0.267,9,13,0.692,79
3/22/14,Michigan,Texas,W 79-65,200,24,54,0.444,10,26,0.385,14,28,0.5,17,21,0.81,79
3/27/14,Florida,UCLA,W 79-68,200,29,58,0.5,21,37,0.568,8,21,0.381,13,18,0.722,79
3/19/15,Kentucky,Hampton,W 79-56,200,28,61,0.459,25,51,0.49,3,10,0.3,20,28,0.714,79
3/20/15,Virginia,Belmont,W 79-67,200,26,57,0.456,20,40,0.5,6,17,0.353,21,25,0.84,79
3/20/15,Oregon,Oklahoma State,W 79-73,200,29,53,0.547,22,34,0.647,7,19,0.368,14,18,0.778,79
3/26/15,Wisconsin,UNC,W 79-72,200,26,56,0.464,19,35,0.543,7,21,0.333,20,23,0.87,79
3/17/11,Cincinnati,Missouri,W 78-63,200,29,54,0.537,25,43,0.581,4,11,0.364,16,22,0.727,78
3/17/11,UCLA,Michigan State,W 78-76,200,22,48,0.458,18,37,0.486,4,11,0.364,30,47,0.638,78
3/13/12,BYU,Iona,W 78-72,200,30,62,0.484,23,42,0.548,7,20,0.35,11,20,0.55,78
3/15/12,Ohio State,Loyola (MD),W 78-59,200,26,58,0.448,21,44,0.477,5,14,0.357,21,26,0.808,78
3/22/13,Fla. Gulf Coast,Georgetown,W 78-68,200,21,49,0.429,15,34,0.441,6,15,0.4,30,44,0.682,78
3/22/13,Miami (FL),Pacific,W 78-49,200,24,52,0.462,12,30,0.4,12,22,0.545,18,21,0.857,78
3/22/13,UNC,Villanova,W 78-71,200,24,49,0.49,13,28,0.464,11,21,0.524,19,27,0.704,78
3/23/13,Michigan,VCU,W 78-53,200,31,60,0.517,25,40,0.625,6,20,0.3,10,11,0.909,78
3/24/13,Florida,Minnesota,W 78-64,200,21,37,0.568,11,17,0.647,10,20,0.5,26,36,0.722,78
3/24/13,Ohio State,Iowa State,W 78-75,200,25,49,0.51,16,31,0.516,9,18,0.5,19,26,0.731,78
3/19/14,Tennessee,Iowa,W 78-65 (OT),225,24,54,0.444,19,33,0.576,5,21,0.238,25,30,0.833,78
3/20/14,Delaware,Michigan State,L 78-93,200,20,55,0.364,12,35,0.343,8,20,0.4,30,39,0.769,78
3/21/14,Mercer,Duke,W 78-71,200,25,45,0.556,20,32,0.625,5,13,0.385,23,28,0.821,78
3/23/14,Kentucky,Wichita State,W 78-76,200,27,50,0.54,19,32,0.594,8,18,0.444,16,22,0.727,78
3/23/14,Virginia,Memphis,W 78-60,200,30,54,0.556,25,43,0.581,5,11,0.455,13,16,0.813,78
3/21/15,Arkansas,UNC,L 78-87,200,24,65,0.369,16,40,0.4,8,25,0.32,22,27,0.815,78
3/22/15,Wichita State,Kansas,W 78-65,200,25,51,0.49,15,31,0.484,10,20,0.5,18,24,0.75,78
3/26/15,Kentucky,West Virginia,W 78-39,200,24,50,0.48,20,35,0.571,4,15,0.267,26,32,0.813,78
3/28/15,Arizona,Wisconsin,L 78-85,200,24,43,0.558,22,37,0.595,2,6,0.333,28,30,0.933,78
3/15/11,Little Rock,UNC Asheville,L 77-81 (OT),225,24,56,0.429,15,27,0.556,9,29,0.31,20,26,0.769,77
3/18/11,Arizona,Memphis,W 77-75,200,23,50,0.46,18,31,0.581,5,19,0.263,26,31,0.839,77
3/18/11,Syracuse,Indiana State,W 77-60,200,23,44,0.523,16,28,0.571,7,16,0.438,24,31,0.774,77
3/24/11,Duke,Arizona,L 77-93,200,27,58,0.466,22,44,0.5,5,14,0.357,18,22,0.818,77
3/25/11,Kansas,Richmond,W 77-57,200,30,63,0.476,21,44,0.477,9,19,0.474,8,10,0.8,77
3/15/12,Iowa State,UConn,W 77-64,200,26,54,0.481,20,38,0.526,6,16,0.375,19,20,0.95,77
3/15/12,Gonzaga,West Virginia,W 77-54,200,28,50,0.56,19,33,0.576,9,17,0.529,12,16,0.75,77
3/16/12,UNC,Vermont,W 77-58,200,27,65,0.415,22,47,0.468,5,18,0.278,18,24,0.75,77
3/24/12,Ohio State,Syracuse,W 77-70,200,21,51,0.412,17,38,0.447,4,13,0.308,31,42,0.738,77
3/29/13,Louisville,Oregon,W 77-69,200,28,52,0.538,24,39,0.615,4,13,0.308,17,26,0.654,77
3/20/14,Pitt,Colorado,W 77-48,200,31,61,0.508,27,47,0.574,4,14,0.286,11,12,0.917,77
3/20/14,Syracuse,Western Mich.,W 77-53,200,28,57,0.491,21,40,0.525,7,17,0.412,14,17,0.824,77
3/21/14,Oklahoma State,Gonzaga,L 77-85,200,26,65,0.4,23,50,0.46,3,15,0.2,22,37,0.595,77
3/21/14,Providence,UNC,L 77-79,200,28,53,0.528,24,37,0.649,4,16,0.25,17,21,0.81,77
3/21/14,Stephen F. Austin,VCU,W 77-75 (OT),225,27,51,0.529,21,35,0.6,6,16,0.375,17,23,0.739,77
3/22/14,UConn,Villanova,W 77-65,200,23,52,0.442,14,32,0.438,9,20,0.45,22,28,0.786,77
3/22/14,Oregon,Wisconsin,L 77-85,200,24,49,0.49,16,31,0.516,8,18,0.444,21,23,0.913,77
3/23/14,UCLA,Stephen F. Austin,W 77-60,200,29,53,0.547,25,39,0.641,4,14,0.286,15,23,0.652,77
3/18/15,North Florida,Robert Morris,L 77-81,200,25,52,0.481,16,30,0.533,9,22,0.409,18,26,0.692,77
3/17/11,Clemson,West Virginia,L 76-84,200,25,58,0.431,20,37,0.541,5,21,0.238,21,26,0.808,76
3/17/11,Michigan State,UCLA,L 76-78,200,25,62,0.403,15,37,0.405,10,25,0.4,16,21,0.762,76
3/20/11,Purdue,VCU,L 76-94,200,30,67,0.448,22,42,0.524,8,25,0.32,8,11,0.727,76
3/27/11,Kentucky,UNC,W 76-69,200,27,56,0.482,15,34,0.441,12,22,0.545,10,16,0.625,76
3/22/13,Iowa State,Notre Dame,W 76-58,199,29,59,0.492,20,38,0.526,9,21,0.429,9,12,0.75,76
3/22/13,Temple,NC State,W 76-72,200,24,50,0.48,17,32,0.531,7,18,0.389,21,33,0.636,76
3/23/13,Wichita State,Gonzaga,W 76-70,200,25,50,0.5,11,22,0.5,14,28,0.5,12,18,0.667,76
3/24/13,La Salle,Ole Miss,W 76-74,200,27,55,0.491,18,32,0.563,9,23,0.391,13,18,0.722,76
4/8/13,Michigan,Louisville,L 76-82,200,25,48,0.521,17,30,0.567,8,18,0.444,18,25,0.72,76
3/21/14,Creighton,Louisiana,W 76-66,200,28,54,0.519,19,31,0.613,9,23,0.391,11,21,0.524,76
3/21/14,UCLA,Tulsa,W 76-59,200,29,63,0.46,24,47,0.511,5,16,0.313,13,15,0.867,76
3/23/14,Wichita State,Kentucky,L 76-78,200,27,49,0.551,17,28,0.607,10,21,0.476,12,18,0.667,76
3/28/14,Iowa State,UConn,L 76-81,200,32,69,0.464,26,53,0.491,6,16,0.375,6,15,0.4,76
3/19/15,Xavier,Ole Miss,W 76-57,200,26,56,0.464,16,33,0.485,10,23,0.435,14,21,0.667,76
3/20/15,North Dakota St.,Gonzaga,L 76-86,200,29,54,0.537,19,33,0.576,10,21,0.476,8,12,0.667,76
3/20/15,Indiana,Wichita State,L 76-81,200,24,59,0.407,13,37,0.351,11,22,0.5,17,20,0.85,76
3/20/15,San Diego State,St. John's (NY),W 76-64,200,25,53,0.472,16,31,0.516,9,22,0.409,17,30,0.567,76
3/29/15,Michigan State,Louisville,W 76-70 (OT),225,26,60,0.433,17,37,0.459,9,23,0.391,15,20,0.75,76
3/18/11,Memphis,Arizona,L 75-77,200,26,53,0.491,20,38,0.526,6,15,0.4,17,24,0.708,75
3/18/11,Michigan,Tennessee,W 75-45,200,33,64,0.516,24,38,0.632,9,26,0.346,0,1,0,75
3/18/11,Ohio State,UTSA,W 75-46,200,29,52,0.558,17,28,0.607,12,24,0.5,5,8,0.625,75
3/15/12,New Mexico,CS Long Beach,W 75-68,200,25,50,0.5,18,29,0.621,7,21,0.333,18,24,0.75,75
3/16/12,Lehigh,Duke,W 75-70,200,22,52,0.423,16,34,0.471,6,18,0.333,25,37,0.676,75
3/17/12,Syracuse,Kansas State,W 75-59,200,23,45,0.511,17,36,0.472,6,9,0.667,23,29,0.793,75
3/23/12,Baylor,Xavier,W 75-70,200,29,57,0.509,24,42,0.571,5,15,0.333,12,14,0.857,75
3/24/13,Iowa State,Ohio State,L 75-78,201,23,52,0.442,11,27,0.407,12,25,0.48,17,23,0.739,75
3/20/14,Wisconsin,American,W 75-35,200,26,52,0.5,16,29,0.552,10,23,0.435,13,14,0.929,75
3/20/14,Oklahoma,North Dakota St.,L 75-80 (OT),225,25,72,0.347,13,42,0.31,12,30,0.4,13,18,0.722,75
3/21/14,N.C. Central,Iowa State,L 75-93,200,30,65,0.462,25,49,0.51,5,16,0.313,10,12,0.833,75
3/21/14,VCU,Stephen F. Austin,L 75-77 (OT),225,30,65,0.462,22,44,0.5,8,21,0.381,7,11,0.636,75
3/30/14,Kentucky,Michigan,W 75-72,200,31,58,0.534,24,47,0.511,7,11,0.636,6,11,0.545,75
3/19/15,Ohio State,VCU,W 75-72 (OT),225,28,57,0.491,22,42,0.524,6,15,0.4,13,22,0.591,75
3/20/15,Kansas,New Mexico St.,W 75-56,200,27,50,0.54,18,37,0.486,9,13,0.692,12,15,0.8,75
3/21/15,UAB,UCLA,L 75-92,201,29,66,0.439,17,40,0.425,12,26,0.462,5,10,0.5,75
3/21/15,Utah,Georgetown,W 75-64,199,22,38,0.579,14,24,0.583,8,14,0.571,23,32,0.719,75
3/21/15,Xavier,Georgia State,W 75-67,200,23,34,0.676,16,21,0.762,7,13,0.538,22,25,0.88,75
3/27/15,Louisville,NC State,W 75-65,200,27,54,0.5,24,42,0.571,3,12,0.25,18,27,0.667,75
3/17/11,BYU,Wofford,W 74-66,200,24,61,0.393,18,39,0.462,6,22,0.273,20,24,0.833,74
3/17/11,Pitt,UNC Asheville,W 74-51,200,25,59,0.424,17,40,0.425,8,19,0.421,16,25,0.64,74
3/18/11,VCU,Georgetown,W 74-56,200,18,44,0.409,6,19,0.316,12,25,0.48,26,39,0.667,74
3/24/11,BYU,Florida,L 74-83 (OT),225,25,71,0.352,15,34,0.441,10,37,0.27,14,16,0.875,74
3/24/11,UConn,San Diego State,W 74-67,200,27,57,0.474,19,41,0.463,8,16,0.5,12,16,0.75,74
3/26/11,Butler,Florida,W 74-71 (OT),225,24,60,0.4,15,27,0.556,9,33,0.273,17,27,0.63,74
3/16/12,Georgetown,Belmont,W 74-59,200,30,49,0.612,25,37,0.676,5,12,0.417,9,13,0.692,74
3/23/13,Arizona,Harvard,W 74-51,200,27,49,0.551,18,34,0.529,9,15,0.6,11,16,0.688,74
3/23/13,Marquette,Butler,W 74-72,200,23,54,0.426,18,42,0.429,5,12,0.417,23,27,0.852,74
3/23/13,Oregon,Saint Louis,W 74-57,200,28,53,0.528,20,42,0.476,8,11,0.727,10,16,0.625,74
3/24/13,Ole Miss,La Salle,L 74-76,200,30,63,0.476,26,44,0.591,4,19,0.211,10,21,0.476,74
3/18/14,NC State,Xavier,W 74-59,200,29,53,0.547,25,39,0.641,4,14,0.286,12,16,0.75,74
3/21/14,Baylor,Nebraska,W 74-60,200,17,42,0.405,15,29,0.517,2,13,0.154,38,48,0.792,74
3/28/14,Kentucky,Louisville,W 74-69,200,24,55,0.436,20,41,0.488,4,14,0.286,22,27,0.815,74
4/5/14,Kentucky,Wisconsin,W 74-73,199,29,58,0.5,27,53,0.509,2,5,0.4,14,21,0.667,74
3/17/15,Hampton,Manhattan,W 74-64,200,26,53,0.491,23,46,0.5,3,7,0.429,19,34,0.559,74
3/19/15,Eastern Wash.,Georgetown,L 74-84,200,26,64,0.406,17,36,0.472,9,28,0.321,13,15,0.867,74
3/27/15,Gonzaga,UCLA,W 74-62,200,27,67,0.403,24,48,0.5,3,19,0.158,17,23,0.739,74
3/17/11,Kansas State,Utah State,W 73-68,200,22,54,0.407,17,37,0.459,5,17,0.294,24,28,0.857,73
3/18/11,Illinois,UNLV,W 73-62,200,28,47,0.596,21,34,0.618,7,13,0.538,10,14,0.714,73
3/19/11,Florida,UCLA,W 73-65,200,27,54,0.5,21,40,0.525,6,14,0.429,13,17,0.765,73
3/20/11,Duke,Michigan,W 73-71,200,25,49,0.51,20,29,0.69,5,20,0.25,18,25,0.72,73
3/20/11,Kansas,Illinois,W 73-59,200,27,52,0.519,23,40,0.575,4,12,0.333,15,20,0.75,73
3/15/12,Wisconsin,Montana,W 73-49,200,23,48,0.479,13,29,0.448,10,19,0.526,17,19,0.895,73
3/17/12,Ohio State,Gonzaga,W 73-66,200,25,53,0.472,16,29,0.552,9,24,0.375,14,18,0.778,73
3/18/12,Creighton,UNC,L 73-87,200,28,68,0.412,20,48,0.417,8,20,0.4,9,12,0.75,73
3/23/12,UNC,Ohio,W 73-65 (OT),225,26,65,0.4,19,43,0.442,7,22,0.318,14,24,0.583,73
3/19/13,N.C. A&T,Liberty,W 73-72,200,27,52,0.519,19,34,0.559,8,18,0.444,11,19,0.579,73
3/21/13,Wichita State,Pitt,W 73-55,200,19,49,0.388,17,29,0.586,2,20,0.1,33,41,0.805,73
3/22/13,Duke,Albany (NY),W 73-61,200,27,46,0.587,23,35,0.657,4,11,0.364,15,21,0.714,73
3/28/13,Ohio State,Arizona,W 73-70,201,22,52,0.423,15,39,0.385,7,13,0.538,22,26,0.846,73
3/20/14,Villanova,Milwaukee,W 73-53,200,28,62,0.452,24,39,0.615,4,23,0.174,13,16,0.813,73
3/20/14,San Diego State,New Mexico St.,W 73-69 (OT),225,23,59,0.39,17,42,0.405,6,17,0.353,21,27,0.778,73
3/22/14,Harvard,Michigan State,L 73-80,200,22,53,0.415,16,36,0.444,6,17,0.353,23,30,0.767,73
3/28/14,Michigan,Tennessee,W 73-71,200,27,49,0.551,16,29,0.552,11,20,0.55,8,10,0.8,73
4/5/14,Wisconsin,Kentucky,L 73-74,200,23,50,0.46,15,30,0.5,8,20,0.4,19,20,0.95,73
3/20/15,Oklahoma State,Oregon,L 73-79,200,27,60,0.45,17,31,0.548,10,29,0.345,9,13,0.692,73
3/21/15,Arizona,Ohio State,W 73-58,200,23,63,0.365,16,44,0.364,7,19,0.368,20,24,0.833,73
3/17/11,Wisconsin,Belmont,W 72-58,200,20,40,0.5,8,18,0.444,12,22,0.545,20,25,0.8,72
3/18/11,Kansas,Boston U.,W 72-53,200,29,57,0.509,20,37,0.541,9,20,0.45,5,8,0.625,72
3/25/11,VCU,Florida State,W 72-71 (OT),225,24,53,0.453,12,27,0.444,12,26,0.462,12,20,0.6,72
3/13/12,Iona,BYU,L 72-78,200,31,70,0.443,25,45,0.556,6,25,0.24,4,8,0.5,72
3/15/12,Syracuse,UNC Asheville,W 72-65,200,25,56,0.446,20,33,0.606,5,23,0.217,17,24,0.708,72
3/16/12,Purdue,Saint Mary's,W 72-69,200,26,57,0.456,21,41,0.512,5,16,0.313,15,18,0.833,72
3/24/12,Louisville,Florida,W 72-68,200,27,60,0.45,21,44,0.477,6,16,0.375,12,15,0.8,72
3/19/13,Liberty,N.C. A&T,L 72-73,200,23,54,0.426,13,31,0.419,10,23,0.435,16,18,0.889,72
3/21/13,Missouri,Colorado State,L 72-84,200,24,57,0.421,17,34,0.5,7,23,0.304,17,19,0.895,72
3/22/13,NC State,Temple,L 72-76,201,29,52,0.558,25,39,0.641,4,13,0.308,10,16,0.625,72
3/23/13,Butler,Marquette,L 72-74,200,24,56,0.429,13,32,0.406,11,24,0.458,13,19,0.684,72
3/28/13,Wichita State,La Salle,W 72-58,200,30,67,0.448,25,55,0.455,5,12,0.417,7,9,0.778,72
4/6/13,Louisville,Wichita State,W 72-68,200,22,49,0.449,13,24,0.542,9,25,0.36,19,29,0.655,72
3/27/14,Stanford,Dayton,L 72-82,200,22,58,0.379,17,37,0.459,5,21,0.238,23,33,0.697,72
3/30/14,Michigan,Kentucky,L 72-75,200,27,57,0.474,20,39,0.513,7,18,0.389,11,14,0.786,72
3/19/15,Texas Southern,Arizona,L 72-93,200,24,51,0.471,19,39,0.487,5,12,0.417,19,30,0.633,72
3/19/15,VCU,Ohio State,L 72-75 (OT),225,24,63,0.381,14,37,0.378,10,26,0.385,14,19,0.737,72
3/20/15,Coastal Caro.,Wisconsin,L 72-86,200,28,58,0.483,21,46,0.457,7,12,0.583,9,11,0.818,72
3/22/15,Oklahoma,Dayton,W 72-66,200,22,49,0.449,13,31,0.419,9,18,0.5,19,24,0.792,72
3/22/15,Wisconsin,Oregon,W 72-65,200,22,51,0.431,15,28,0.536,7,23,0.304,21,29,0.724,72
3/26/15,UNC,Wisconsin,L 72-79,200,26,56,0.464,18,43,0.419,8,13,0.615,12,18,0.667,72
3/17/11,St. John's (NY),Gonzaga,L 71-86,200,27,58,0.466,20,43,0.465,7,15,0.467,10,15,0.667,71
3/19/11,Butler,Pitt,W 71-70,200,24,52,0.462,12,25,0.48,12,27,0.444,11,14,0.786,71
3/19/11,Kentucky,West Virginia,W 71-63,200,24,50,0.48,18,32,0.563,6,18,0.333,17,24,0.708,71
3/19/11,San Diego State,Temple,W 71-64 (2OT),250,28,65,0.431,22,54,0.407,6,11,0.545,9,9,1,71
3/20/11,Michigan,Duke,L 71-73,200,27,53,0.509,20,32,0.625,7,21,0.333,10,11,0.909,71
3/20/11,Florida State,Notre Dame,W 71-57,200,22,48,0.458,13,29,0.448,9,19,0.474,18,25,0.72,71
3/25/11,Florida State,VCU,L 71-72 (OT),225,26,71,0.366,19,52,0.365,7,19,0.368,12,18,0.667,71
3/26/11,Florida,Butler,L 71-74 (OT),225,25,57,0.439,22,43,0.512,3,14,0.214,18,22,0.818,71
3/27/11,VCU,Kansas,W 71-61,200,21,53,0.396,9,28,0.321,12,25,0.48,17,22,0.773,71
3/14/12,Vermont,Lamar,W 71-59,200,25,50,0.5,21,39,0.538,4,11,0.364,17,24,0.708,71
3/16/12,Florida,Virginia,W 71-45,200,28,53,0.528,24,30,0.8,4,23,0.174,11,17,0.647,71
3/17/12,Iowa State,Kentucky,L 71-87,200,25,61,0.41,22,39,0.564,3,22,0.136,18,25,0.72,71
3/20/13,Boise State,La Salle,L 71-80,200,26,53,0.491,19,35,0.543,7,18,0.389,12,18,0.667,71
3/21/13,Michigan,S Dakota St.,W 71-56,200,28,55,0.509,19,35,0.543,9,20,0.45,6,9,0.667,71
3/22/13,Villanova,UNC,L 71-78,200,27,61,0.443,23,40,0.575,4,21,0.19,13,19,0.684,71
3/24/13,San Diego State,Fla. Gulf Coast,L 71-81,200,27,61,0.443,19,38,0.5,8,23,0.348,9,13,0.692,71
3/28/13,Marquette,Miami (FL),W 71-61,200,27,50,0.54,24,44,0.545,3,6,0.5,14,19,0.737,71
3/29/13,Duke,Michigan State,W 71-61,200,20,49,0.408,13,31,0.419,7,18,0.389,24,26,0.923,71
3/18/14,Albany (NY),Mt. St. Mary's,W 71-64,200,27,47,0.574,25,38,0.658,2,9,0.222,15,19,0.789,71
3/20/14,Louisville,Manhattan,W 71-64,200,20,55,0.364,16,42,0.381,4,13,0.308,27,35,0.771,71
3/21/14,Duke,Mercer,L 71-78,200,22,62,0.355,7,25,0.28,15,37,0.405,12,13,0.923,71
3/21/14,Memphis,George Washington,W 71-66,200,27,55,0.491,21,33,0.636,6,22,0.273,11,16,0.688,71
3/28/14,Tennessee,Michigan,L 71-73,200,30,57,0.526,27,46,0.587,3,11,0.273,8,14,0.571,71
3/20/15,Northern Iowa,Wyoming,W 71-54,200,23,50,0.46,14,32,0.438,9,18,0.5,16,18,0.889,71
3/21/15,NC State,Villanova,W 71-68,200,24,53,0.453,21,42,0.5,3,11,0.273,20,27,0.741,71
4/4/15,Wisconsin,Kentucky,W 71-64,200,23,48,0.479,16,31,0.516,7,17,0.412,18,22,0.818,71
3/15/11,Clemson,UAB,W 70-52,200,26,50,0.52,22,37,0.595,4,13,0.308,14,16,0.875,70
3/16/11,UTSA,Alabama State,W 70-61,200,23,54,0.426,19,38,0.5,4,16,0.25,20,30,0.667,70
3/19/11,Pitt,Butler,L 70-71,200,26,46,0.565,20,35,0.571,6,11,0.545,12,18,0.667,70
3/19/11,Wisconsin,Kansas State,W 70-65,200,21,50,0.42,12,30,0.4,9,20,0.45,19,23,0.826,70
3/20/11,Arizona,Texas,W 70-69,200,24,54,0.444,16,40,0.4,8,14,0.571,14,22,0.636,70
4/2/11,Butler,VCU,W 70-62,200,21,59,0.356,13,36,0.361,8,23,0.348,20,26,0.769,70
3/15/12,Harvard,Vanderbilt,L 70-79,200,25,56,0.446,16,32,0.5,9,24,0.375,11,14,0.786,70
3/15/12,Kansas State,Southern Miss,W 70-64,200,21,42,0.5,19,30,0.633,2,12,0.167,26,34,0.765,70
3/16/12,Duke,Lehigh,L 70-75,200,24,58,0.414,18,32,0.563,6,26,0.231,16,23,0.696,70
3/18/12,Xavier,Lehigh,W 70-58,200,24,54,0.444,17,39,0.436,7,15,0.467,15,21,0.714,70
3/23/12,Xavier,Baylor,L 70-75,200,24,56,0.429,21,41,0.512,3,15,0.2,19,24,0.792,70
3/24/12,Syracuse,Ohio State,L 70-77,200,22,53,0.415,16,37,0.432,6,16,0.375,20,25,0.8,70
3/25/12,Baylor,Kentucky,L 70-82,200,25,64,0.391,21,50,0.42,4,14,0.286,16,19,0.842,70
3/22/13,Iona,Ohio State,L 70-95,200,23,65,0.354,17,37,0.459,6,28,0.214,18,21,0.857,70
3/22/13,San Diego State,Oklahoma,W 70-55,200,24,56,0.429,18,41,0.439,6,15,0.4,16,17,0.941,70
3/23/13,Gonzaga,Wichita State,L 70-76,200,21,59,0.356,13,36,0.361,8,23,0.348,20,29,0.69,70
3/23/13,Michigan State,Memphis,W 70-48,200,26,52,0.5,22,36,0.611,4,16,0.25,14,22,0.636,70
3/24/13,Kansas,UNC,W 70-58,200,24,55,0.436,19,41,0.463,5,14,0.357,17,21,0.81,70
3/28/13,Arizona,Ohio State,L 70-73,201,23,52,0.442,17,34,0.5,6,18,0.333,18,20,0.9,70
3/30/13,Wichita State,Ohio State,W 70-66,200,22,59,0.373,14,39,0.359,8,20,0.4,18,23,0.783,70
3/21/14,Virginia,Coastal Caro.,W 70-59,200,21,40,0.525,13,23,0.565,8,17,0.471,20,25,0.8,70
3/27/14,Arizona,San Diego State,W 70-64,200,23,48,0.479,18,36,0.5,5,12,0.417,19,25,0.76,70
3/20/15,Michigan State,Georgia,W 70-63,200,26,57,0.456,19,39,0.487,7,18,0.389,11,19,0.579,70
3/26/15,Wichita State,Notre Dame,L 70-81,200,26,65,0.4,23,47,0.489,3,18,0.167,15,19,0.789,70
3/29/15,Louisville,Michigan State,L 70-76 (OT),225,23,64,0.359,19,53,0.358,4,11,0.364,20,29,0.69,70
3/17/11,Richmond,Vanderbilt,W 69-66,200,26,56,0.464,14,32,0.438,12,24,0.5,5,12,0.417,69
3/18/11,Notre Dame,Akron,W 69-56,200,21,47,0.447,14,30,0.467,7,17,0.412,20,26,0.769,69
3/19/11,UConn,Cincinnati,W 69-58,200,19,44,0.432,13,28,0.464,6,16,0.375,25,30,0.833,69
3/20/11,Texas,Arizona,L 69-70,200,24,53,0.453,21,42,0.5,3,11,0.273,18,22,0.818,69
3/27/11,UNC,Kentucky,L 69-76,200,27,62,0.435,24,46,0.522,3,16,0.188,12,15,0.8,69
3/15/12,Louisville,Davidson,W 69-62,200,21,52,0.404,20,47,0.426,1,5,0.2,26,36,0.722,69
3/16/12,Saint Mary's,Purdue,L 69-72,200,27,64,0.422,23,39,0.59,4,25,0.16,11,13,0.846,69
3/31/12,Kentucky,Louisville,W 69-61,200,28,49,0.571,26,42,0.619,2,7,0.286,11,20,0.55,69
3/29/13,Oregon,Louisville,L 69-77,200,27,61,0.443,22,47,0.468,5,14,0.357,10,17,0.588,69
3/19/14,Texas Southern,Cal Poly,L 69-81,200,24,50,0.48,20,37,0.541,4,13,0.308,17,22,0.773,69
3/20/14,New Mexico St.,San Diego State,L 69-73 (OT),225,26,65,0.4,21,49,0.429,5,16,0.313,12,20,0.6,69
3/21/14,Eastern Ky.,Kansas,L 69-80,200,22,57,0.386,10,26,0.385,12,31,0.387,13,16,0.813,69
3/27/14,Wisconsin,Baylor,W 69-52,200,26,51,0.51,20,35,0.571,6,16,0.375,11,20,0.55,69
3/28/14,Louisville,Kentucky,L 69-74,200,26,53,0.491,22,38,0.579,4,15,0.267,13,23,0.565,69
3/19/15,Notre Dame,Northeastern,W 69-65,200,27,47,0.574,25,41,0.61,2,6,0.333,13,18,0.722,69
3/20/15,Oklahoma,Albany (NY),W 69-60,200,25,57,0.439,18,33,0.545,7,24,0.292,12,16,0.75,69
3/22/15,West Virginia,Maryland,W 69-59,200,24,60,0.4,17,41,0.415,7,19,0.368,14,19,0.737,69
3/17/11,Utah State,Kansas State,L 68-73,200,23,50,0.46,17,32,0.531,6,18,0.333,16,21,0.762,68
3/17/11,San Diego State,Northern Colo.,W 68-50,200,27,66,0.409,18,44,0.409,9,22,0.409,5,8,0.625,68
3/18/11,Washington,Georgia,W 68-65,200,26,60,0.433,22,42,0.524,4,18,0.222,12,14,0.857,68
3/15/12,Baylor,S Dakota St.,W 68-60,200,23,52,0.442,15,32,0.469,8,20,0.4,14,20,0.7,68
3/15/12,BYU,Marquette,L 68-88,200,23,61,0.377,16,42,0.381,7,19,0.368,15,22,0.682,68
3/15/12,Colorado,UNLV,W 68-64,200,22,48,0.458,15,36,0.417,7,12,0.583,17,27,0.63,68
3/15/12,CS Long Beach,New Mexico,L 68-75,200,28,65,0.431,24,49,0.49,4,16,0.25,8,14,0.571,68
3/22/12,Florida,Marquette,W 68-58,200,24,59,0.407,17,32,0.531,7,27,0.259,13,15,0.867,68
3/24/12,Florida,Louisville,L 68-72,200,24,48,0.5,16,28,0.571,8,20,0.4,12,18,0.667,68
3/20/13,James Madison,LIU,W 68-55,200,26,56,0.464,18,33,0.545,8,23,0.348,8,12,0.667,68
3/21/13,Butler,Bucknell,W 68-56,200,20,55,0.364,17,38,0.447,3,17,0.176,25,28,0.893,68
3/21/13,Harvard,New Mexico,W 68-62,200,22,42,0.524,14,24,0.583,8,18,0.444,16,20,0.8,68
3/21/13,Oregon,Oklahoma State,W 68-55,201,23,59,0.39,15,37,0.405,8,22,0.364,14,21,0.667,68
3/22/13,Georgetown,Fla. Gulf Coast,L 68-78,200,24,64,0.375,17,37,0.459,7,27,0.259,13,20,0.65,68
4/6/13,Wichita State,Louisville,L 68-72,200,22,54,0.407,16,34,0.471,6,20,0.3,18,24,0.75,68
3/20/14,BYU,Oregon,L 68-87,200,20,61,0.328,15,42,0.357,5,19,0.263,23,30,0.767,68
3/21/14,Arizona,Weber State,W 68-59,200,26,47,0.553,19,33,0.576,7,14,0.5,9,16,0.563,68
3/27/14,UCLA,Florida,L 68-79,200,27,64,0.422,24,46,0.522,3,18,0.167,11,15,0.733,68
3/20/15,West Virginia,Buffalo,W 68-62,200,22,49,0.449,17,33,0.515,5,16,0.313,19,27,0.704,68
3/21/15,Villanova,NC State,L 68-71,200,19,61,0.311,10,33,0.303,9,28,0.321,21,23,0.913,68
3/22/15,Duke,San Diego State,W 68-49,200,30,55,0.545,24,41,0.585,6,14,0.429,2,2,1,68
3/22/15,Iowa,Gonzaga,L 68-87,200,28,60,0.467,23,45,0.511,5,15,0.333,7,10,0.7,68
3/26/15,Arizona,Xavier,W 68-60,200,22,54,0.407,15,32,0.469,7,22,0.318,17,19,0.895,68
3/28/15,Kentucky,Notre Dame,W 68-66,200,25,47,0.532,21,39,0.538,4,8,0.5,14,20,0.7,68
4/6/15,Duke,Wisconsin,W 68-63,200,24,51,0.471,20,40,0.5,4,11,0.364,16,20,0.8,68
3/19/11,Gonzaga,BYU,L 67-89,200,24,57,0.421,22,48,0.458,2,9,0.222,17,21,0.81,67
3/24/11,San Diego State,UConn,L 67-74,200,27,64,0.422,20,42,0.476,7,22,0.318,6,13,0.462,67
3/16/12,LIU,Michigan State,L 67-89,200,22,50,0.44,14,33,0.424,8,17,0.471,15,23,0.652,67
3/16/12,Xavier,Notre Dame,W 67-63,200,22,44,0.5,17,34,0.5,5,10,0.5,18,27,0.667,67
3/25/12,UNC,Kansas,L 67-80,200,28,64,0.438,26,47,0.553,2,17,0.118,9,12,0.75,67
4/2/12,Kentucky,Kansas,W 67-59,200,23,56,0.411,17,42,0.405,6,14,0.429,15,21,0.714,67
3/19/13,Saint Mary's,Middle Tenn.,W 67-54,200,21,46,0.457,13,32,0.406,8,14,0.571,17,25,0.68,67
3/22/13,Creighton,Cincinnati,W 67-63,200,19,42,0.452,12,27,0.444,7,15,0.467,22,25,0.88,67
3/20/14,Florida,Albany (NY),W 67-55,200,25,49,0.51,22,37,0.595,3,12,0.25,14,18,0.778,67
3/21/14,UMass,Tennessee,L 67-86,200,28,66,0.424,25,55,0.455,3,11,0.273,8,11,0.727,67
3/19/15,UNC,Harvard,W 67-65,200,27,49,0.551,22,42,0.524,5,7,0.714,8,13,0.615,67
3/20/15,Belmont,Virginia,L 67-79,200,27,57,0.474,19,32,0.594,8,25,0.32,5,6,0.833,67
3/21/15,Notre Dame,Butler,W 67-64 (OT),225,22,51,0.431,16,31,0.516,6,20,0.3,17,22,0.773,67
3/21/15,Georgia State,Xavier,L 67-75,200,26,46,0.565,20,32,0.625,6,14,0.429,9,13,0.692,67
3/17/11,Wofford,BYU,L 66-74,200,22,56,0.393,18,37,0.486,4,19,0.211,18,24,0.75,66
3/17/11,Temple,Penn State,W 66-64,200,24,49,0.49,19,31,0.613,5,18,0.278,13,15,0.867,66
3/17/11,Vanderbilt,Richmond,L 66-69,200,23,46,0.5,17,33,0.515,6,13,0.462,14,23,0.609,66
3/18/11,Marquette,Xavier,W 66-55,200,24,45,0.533,19,33,0.576,5,12,0.417,13,19,0.684,66
3/20/11,George Mason,Ohio State,L 66-98,200,26,60,0.433,18,42,0.429,8,18,0.444,6,7,0.857,66
3/20/11,Marquette,Syracuse,W 66-62,200,21,51,0.412,16,40,0.4,5,11,0.455,19,23,0.826,66
3/15/12,New Mexico St.,Indiana,L 66-79,200,27,49,0.551,23,37,0.622,4,12,0.333,8,10,0.8,66
3/15/12,Western Ky.,Kentucky,L 66-81,200,25,63,0.397,19,48,0.396,6,15,0.4,10,16,0.625,66
3/16/12,Florida State,St. Bonaventure,W 66-63,200,24,53,0.453,17,34,0.5,7,19,0.368,11,14,0.786,66
3/17/12,Gonzaga,Ohio State,L 66-73,200,22,56,0.393,14,33,0.424,8,23,0.348,14,19,0.737,66
3/18/12,NC State,Georgetown,W 66-63,200,20,54,0.37,13,39,0.333,7,15,0.467,19,31,0.613,66
3/22/12,Cincinnati,Ohio State,L 66-81,200,26,56,0.464,17,33,0.515,9,23,0.391,5,8,0.625,66
3/23/13,Syracuse,California,W 66-60,200,18,46,0.391,14,36,0.389,4,10,0.4,26,41,0.634,66
3/24/13,Duke,Creighton,W 66-50,200,19,49,0.388,12,29,0.414,7,20,0.35,21,28,0.75,66
3/30/13,Ohio State,Wichita State,L 66-70,200,19,61,0.311,14,36,0.389,5,25,0.2,23,29,0.793,66
3/21/14,Louisiana,Creighton,L 66-76,200,25,66,0.379,21,50,0.42,4,16,0.25,12,17,0.706,66
3/21/14,George Washington,Memphis,L 66-71,200,25,56,0.446,23,44,0.523,2,12,0.167,14,24,0.583,66
3/22/14,Louisville,Saint Louis,W 66-51,200,22,49,0.449,16,32,0.5,6,17,0.353,16,24,0.667,66
3/19/15,Cincinnati,Purdue,W 66-65 (OT),225,25,61,0.41,21,51,0.412,4,10,0.4,12,21,0.571,66
3/19/15,NC State,LSU,W 66-65,200,28,66,0.424,23,42,0.548,5,24,0.208,5,7,0.714,66
3/20/15,Dayton,Providence,W 66-53,200,18,42,0.429,10,19,0.526,8,23,0.348,22,30,0.733,66
3/22/15,Dayton,Oklahoma,L 66-72,200,22,51,0.431,11,30,0.367,11,21,0.524,11,13,0.846,66
3/22/15,Louisville,Northern Iowa,W 66-53,200,22,48,0.458,17,37,0.459,5,11,0.455,17,21,0.81,66
3/28/15,Notre Dame,Kentucky,L 66-68,200,26,56,0.464,22,42,0.524,4,14,0.286,10,13,0.769,66
3/29/15,Duke,Gonzaga,W 66-52,200,21,56,0.375,13,37,0.351,8,19,0.421,16,19,0.842,66
3/18/11,Georgia,Washington,L 65-68,200,23,50,0.46,18,38,0.474,5,12,0.417,14,19,0.737,65
3/18/11,Purdue,St. Peter's,W 65-43,200,23,54,0.426,18,39,0.462,5,15,0.333,14,17,0.824,65
3/19/11,UCLA,Florida,L 65-73,200,23,55,0.418,20,42,0.476,3,13,0.231,16,25,0.64,65
3/19/11,Kansas State,Wisconsin,L 65-70,200,22,48,0.458,16,36,0.444,6,12,0.5,15,22,0.682,65
3/19/11,Richmond,Morehead State,W 65-48,200,26,55,0.473,22,39,0.564,4,16,0.25,9,13,0.692,65
3/26/11,UConn,Arizona,W 65-63,200,23,56,0.411,18,39,0.462,5,17,0.294,14,18,0.778,65
3/14/12,South Florida,California,W 65-54,200,28,49,0.571,23,34,0.676,5,15,0.333,4,8,0.5,65
3/15/12,UNC Asheville,Syracuse,L 65-72,200,21,49,0.429,12,26,0.462,9,23,0.391,14,16,0.875,65
3/16/12,Cincinnati,Texas,W 65-59,200,27,59,0.458,24,43,0.558,3,16,0.188,8,16,0.5,65
3/16/12,Kansas,Detroit,W 65-50,200,23,50,0.46,18,34,0.529,5,16,0.313,14,23,0.609,65
3/16/12,Ohio,Michigan,W 65-60,200,22,43,0.512,16,27,0.593,6,16,0.375,15,17,0.882,65
3/16/12,San Diego State,NC State,L 65-79,200,23,61,0.377,15,38,0.395,8,23,0.348,11,14,0.786,65
3/18/12,Michigan State,Saint Louis,W 65-61,200,25,46,0.543,21,36,0.583,4,10,0.4,11,17,0.647,65
3/23/12,Ohio,UNC,L 65-73 (OT),225,23,71,0.324,11,39,0.282,12,32,0.375,7,8,0.875,65
3/21/13,Michigan State,Valparaiso,W 65-54,199,26,58,0.448,20,43,0.465,6,15,0.4,7,11,0.636,65
3/19/14,Iowa,Tennessee,L 65-78 (OT),225,24,58,0.414,20,42,0.476,4,16,0.25,13,15,0.867,65
3/22/14,Villanova,UConn,L 65-77,200,18,51,0.353,7,20,0.35,11,31,0.355,18,24,0.75,65
3/22/14,Texas,Michigan,L 65-79,201,23,62,0.371,19,51,0.373,4,11,0.364,15,16,0.938,65
3/19/15,Purdue,Cincinnati,L 65-66 (OT),225,26,72,0.361,22,46,0.478,4,26,0.154,9,15,0.6,65
3/19/15,Harvard,UNC,L 65-67,200,21,55,0.382,16,42,0.381,5,13,0.385,18,20,0.9,65
3/19/15,LSU,NC State,L 65-66,200,24,60,0.4,19,45,0.422,5,15,0.333,12,22,0.545,65
3/19/15,Northeastern,Notre Dame,L 65-69,200,27,55,0.491,24,44,0.545,3,11,0.273,8,10,0.8,65
3/20/15,Maryland,Valparaiso,W 65-62,200,19,40,0.475,10,19,0.526,9,21,0.429,18,24,0.75,65
3/22/15,Kansas,Wichita State,L 65-78,200,20,57,0.351,14,36,0.389,6,21,0.286,19,23,0.826,65
3/22/15,Oregon,Wisconsin,L 65-72,200,26,59,0.441,18,40,0.45,8,19,0.421,5,7,0.714,65
3/27/15,NC State,Louisville,L 65-75,200,23,60,0.383,14,40,0.35,9,20,0.45,10,14,0.714,65
3/17/11,Penn State,Temple,L 64-66,200,26,54,0.481,18,35,0.514,8,19,0.421,4,6,0.667,64
3/19/11,Temple,San Diego State,L 64-71 (2OT),250,25,66,0.379,19,52,0.365,6,14,0.429,8,11,0.727,64
3/15/12,UNLV,Colorado,L 64-68,200,23,71,0.324,14,35,0.4,9,36,0.25,9,17,0.529,64
3/15/12,UConn,Iowa State,L 64-77,200,21,56,0.375,14,37,0.378,7,19,0.368,15,22,0.682,64
3/15/12,Southern Miss,Kansas State,L 64-70,200,22,60,0.367,14,37,0.378,8,23,0.348,12,17,0.706,64
3/22/12,Syracuse,Wisconsin,W 64-63,200,27,49,0.551,22,40,0.55,5,9,0.556,5,9,0.556,64
3/31/12,Kansas,Ohio State,W 64-62,200,25,56,0.446,22,45,0.489,3,11,0.273,11,14,0.786,64
3/21/13,Belmont,Arizona,L 64-81,200,20,51,0.392,12,24,0.5,8,27,0.296,16,23,0.696,64
3/21/13,California,UNLV,W 64-61,200,26,59,0.441,21,48,0.438,5,11,0.455,7,16,0.438,64
3/21/13,Gonzaga,Southern,W 64-58,200,23,55,0.418,15,35,0.429,8,20,0.4,10,15,0.667,64
3/21/13,Saint Louis,New Mexico St.,W 64-44,200,25,54,0.463,21,43,0.488,4,11,0.364,10,14,0.714,64
3/22/13,Kansas,Western Ky.,W 64-57,200,20,42,0.476,20,36,0.556,0,6,0,24,30,0.8,64
3/24/13,Minnesota,Florida,L 64-78,200,20,50,0.4,12,32,0.375,8,18,0.444,16,22,0.727,64
3/18/14,Mt. St. Mary's,Albany (NY),L 64-71,200,22,60,0.367,10,23,0.435,12,37,0.324,8,12,0.667,64
3/20/14,Manhattan,Louisville,L 64-71,200,23,51,0.451,20,46,0.435,3,5,0.6,15,21,0.714,64
3/21/14,Wichita State,Cal Poly,W 64-37,200,23,50,0.46,17,31,0.548,6,19,0.316,12,21,0.571,64
3/27/14,San Diego State,Arizona,L 64-70,200,21,54,0.389,17,40,0.425,4,14,0.286,18,23,0.783,64
3/29/14,Wisconsin,Arizona,W 64-63 (OT),225,24,61,0.393,18,44,0.409,6,17,0.353,10,12,0.833,64
3/17/15,Manhattan,Hampton,L 64-74,200,23,62,0.371,17,37,0.459,6,25,0.24,12,21,0.571,64
3/20/15,St. John's (NY),San Diego State,L 64-76,200,27,59,0.458,24,42,0.571,3,17,0.176,7,11,0.636,64
3/21/15,Butler,Notre Dame,L 64-67 (OT),225,21,63,0.333,17,50,0.34,4,13,0.308,18,21,0.857,64
3/21/15,Kentucky,Cincinnati,W 64-51,198,20,54,0.37,16,39,0.41,4,15,0.267,20,28,0.714,64
3/21/15,Georgetown,Utah,L 64-75,199,24,55,0.436,15,30,0.5,9,25,0.36,7,9,0.778,64
4/4/15,Kentucky,Wisconsin,L 64-71,200,26,54,0.481,23,49,0.469,3,5,0.6,9,10,0.9,64
3/17/11,Missouri,Cincinnati,L 63-78,200,24,63,0.381,18,44,0.409,6,19,0.316,9,13,0.692,63
3/19/11,West Virginia,Kentucky,L 63-71,200,22,53,0.415,15,34,0.441,7,19,0.368,12,16,0.75,63
3/25/11,Marquette,UNC,L 63-81,200,23,63,0.365,21,47,0.447,2,16,0.125,15,20,0.75,63
3/26/11,Arizona,UConn,L 63-65,200,24,61,0.393,20,40,0.5,4,21,0.19,11,16,0.688,63
3/16/12,St. Bonaventure,Florida State,L 63-66,200,23,57,0.404,16,43,0.372,7,14,0.5,10,13,0.769,63
3/16/12,Notre Dame,Xavier,L 63-67,200,25,49,0.51,16,28,0.571,9,21,0.429,4,9,0.444,63
3/17/12,Colorado,Baylor,L 63-80,200,23,51,0.451,18,36,0.5,5,15,0.333,12,18,0.667,63
3/17/12,Indiana,VCU,W 63-61,200,24,46,0.522,18,33,0.545,6,13,0.462,9,11,0.818,63
3/18/12,Georgetown,NC State,L 63-66,200,21,51,0.412,13,26,0.5,8,25,0.32,13,17,0.765,63
3/18/12,Kansas,Purdue,W 63-60,200,21,62,0.339,15,38,0.395,6,24,0.25,15,23,0.652,63
3/22/12,Wisconsin,Syracuse,L 63-64,200,21,49,0.429,7,22,0.318,14,27,0.519,7,12,0.583,63
3/22/13,Cincinnati,Creighton,L 63-67,200,27,64,0.422,22,44,0.5,5,20,0.25,4,9,0.444,63
3/22/13,La Salle,Kansas State,W 63-61,200,21,49,0.429,14,31,0.452,7,18,0.389,14,16,0.875,63
3/22/13,UCLA,Minnesota,L 63-83,200,20,63,0.317,16,41,0.39,4,22,0.182,19,25,0.76,63
3/24/13,Miami (FL),Illinois,W 63-59,200,22,55,0.4,13,30,0.433,9,25,0.36,10,15,0.667,63
3/31/13,Duke,Louisville,L 63-85,200,19,52,0.365,15,36,0.417,4,16,0.25,21,28,0.75,63
3/22/14,San Diego State,North Dakota St.,W 63-44,200,19,44,0.432,12,28,0.429,7,16,0.438,18,24,0.75,63
3/23/14,Mercer,Tennessee,L 63-83,200,24,53,0.453,16,31,0.516,8,22,0.364,7,9,0.778,63
3/29/14,Arizona,Wisconsin,L 63-64 (OT),225,23,59,0.39,18,47,0.383,5,12,0.417,12,17,0.706,63
4/5/14,UConn,Florida,W 63-53,200,24,43,0.558,19,31,0.613,5,12,0.417,10,13,0.769,63
3/20/15,Georgia,Michigan State,L 63-70,200,19,57,0.333,15,43,0.349,4,14,0.286,21,26,0.808,63
3/27/15,Duke,Utah,W 63-57,200,20,45,0.444,17,36,0.472,3,9,0.333,20,26,0.769,63
4/6/15,Wisconsin,Duke,L 63-68,200,25,61,0.41,18,40,0.45,7,21,0.333,6,10,0.6,63
3/17/11,Morehead State,Louisville,W 62-61,200,21,57,0.368,12,38,0.316,9,19,0.474,11,18,0.611,62
3/18/11,UNLV,Illinois,L 62-73,200,21,54,0.389,14,30,0.467,7,24,0.292,13,19,0.684,62
3/20/11,Syracuse,Marquette,L 62-66,200,26,47,0.553,21,32,0.656,5,15,0.333,5,7,0.714,62
3/25/11,Kentucky,Ohio State,W 62-60,200,22,48,0.458,16,31,0.516,6,17,0.353,12,14,0.857,62
4/2/11,VCU,Butler,L 62-70,200,23,58,0.397,15,36,0.417,8,22,0.364,8,13,0.615,62
3/15/12,Davidson,Louisville,L 62-69,200,21,60,0.35,17,41,0.415,4,19,0.211,16,23,0.696,62
3/15/12,VCU,Wichita State,W 62-59,200,25,59,0.424,19,36,0.528,6,23,0.261,6,9,0.667,62
3/17/12,Marquette,Murray State,W 62-53,200,21,55,0.382,17,40,0.425,4,15,0.267,16,21,0.762,62
3/18/12,Cincinnati,Florida State,W 62-56,200,19,50,0.38,14,35,0.4,5,15,0.333,19,23,0.826,62
3/18/12,Ohio,South Florida,W 62-56,200,17,43,0.395,8,25,0.32,9,18,0.5,19,25,0.76,62
3/31/12,Ohio State,Kansas,L 62-64,200,20,59,0.339,12,37,0.324,8,22,0.364,14,15,0.933,62
3/21/13,New Mexico,Harvard,L 62-68,200,21,56,0.375,18,42,0.429,3,14,0.214,17,24,0.708,62
3/22/13,James Madison,Indiana,L 62-83,200,26,62,0.419,18,42,0.429,8,20,0.4,2,4,0.5,62
3/29/13,Florida,Fla. Gulf Coast,W 62-50,200,22,57,0.386,18,42,0.429,4,15,0.267,14,23,0.609,62
3/29/14,Florida,Dayton,W 62-52,200,18,48,0.375,13,33,0.394,5,15,0.333,21,28,0.75,62
3/20/15,Buffalo,West Virginia,L 62-68,200,20,44,0.455,14,28,0.5,6,16,0.375,16,25,0.64,62
3/20/15,Valparaiso,Maryland,L 62-65,200,20,56,0.357,8,29,0.276,12,27,0.444,10,18,0.556,62
3/27/15,UCLA,Gonzaga,L 62-74,200,26,67,0.388,23,54,0.426,3,13,0.231,7,11,0.636,62
3/27/15,Michigan State,Oklahoma,W 62-58,200,22,57,0.386,13,30,0.433,9,27,0.333,9,16,0.563,62
3/16/11,Alabama State,UTSA,L 61-70,200,22,62,0.355,15,36,0.417,7,26,0.269,10,12,0.833,61
3/17/11,Louisville,Morehead State,L 61-62,200,22,48,0.458,12,23,0.522,10,25,0.4,7,16,0.438,61
3/18/11,George Mason,Villanova,W 61-57,200,21,52,0.404,17,38,0.447,4,14,0.286,15,24,0.625,61
3/24/11,Butler,Wisconsin,W 61-54,200,19,45,0.422,14,27,0.519,5,18,0.278,18,26,0.692,61
3/27/11,Kansas,VCU,L 61-71,200,22,62,0.355,20,41,0.488,2,21,0.095,15,28,0.536,61
3/16/12,Saint Louis,Memphis,W 61-54,200,21,46,0.457,16,33,0.485,5,13,0.385,14,18,0.778,61
3/17/12,VCU,Indiana,L 61-63,200,23,57,0.404,14,27,0.519,9,30,0.3,6,13,0.462,61
3/18/12,Saint Louis,Michigan State,L 61-65,200,18,51,0.353,11,26,0.423,7,25,0.28,18,23,0.783,61
3/31/12,Louisville,Kentucky,L 61-69,200,24,69,0.348,20,58,0.345,4,11,0.364,9,13,0.692,61
3/21/13,UNLV,California,L 61-64,200,19,59,0.322,13,39,0.333,6,20,0.3,17,26,0.654,61
3/22/13,Albany (NY),Duke,L 61-73,200,19,52,0.365,10,37,0.27,9,15,0.6,14,16,0.875,61
3/22/13,Kansas State,La Salle,L 61-63,200,24,57,0.421,20,44,0.455,4,13,0.308,9,17,0.529,61
3/28/13,Syracuse,Indiana,W 61-50,199,21,48,0.438,17,38,0.447,4,10,0.4,15,20,0.75,61
3/28/13,Miami (FL),Marquette,L 61-71,200,22,63,0.349,14,37,0.378,8,26,0.308,9,12,0.75,61
3/29/13,Michigan State,Duke,L 61-71,200,20,50,0.4,17,38,0.447,3,12,0.25,18,24,0.75,61
4/6/13,Michigan,Syracuse,W 61-56,201,21,53,0.396,13,29,0.448,8,24,0.333,11,20,0.55,61
3/20/14,Harvard,Cincinnati,W 61-57,200,19,44,0.432,13,27,0.481,6,17,0.353,17,28,0.607,61
3/22/14,Florida,Pitt,W 61-45,200,25,58,0.431,20,38,0.526,5,20,0.25,6,9,0.667,61
3/23/14,Gonzaga,Arizona,L 61-84,200,22,54,0.407,16,38,0.421,6,16,0.375,11,13,0.846,61
3/28/14,Michigan State,Virginia,W 61-59,200,21,47,0.447,16,33,0.485,5,14,0.357,14,18,0.778,61
4/4/15,Michigan State,Duke,L 61-81,200,22,55,0.4,15,35,0.429,7,20,0.35,10,16,0.625,61
3/17/11,Butler,Old Dominion,W 60-58,200,22,54,0.407,15,28,0.536,7,26,0.269,9,11,0.818,60
3/18/11,Indiana State,Syracuse,L 60-77,200,22,55,0.4,15,34,0.441,7,21,0.333,9,14,0.643,60
3/25/11,Ohio State,Kentucky,L 60-62,200,19,58,0.328,13,42,0.31,6,16,0.375,16,22,0.727,60
3/15/12,S Dakota St.,Baylor,L 60-68,200,21,50,0.42,11,20,0.55,10,30,0.333,8,14,0.571,60
3/16/12,Michigan,Ohio,L 60-65,200,22,54,0.407,15,31,0.484,7,23,0.304,9,11,0.818,60
3/17/12,Wisconsin,Vanderbilt,W 60-57,200,23,55,0.418,13,22,0.591,10,33,0.303,4,8,0.5,60
3/18/12,Purdue,Kansas,L 60-63,200,20,50,0.4,12,32,0.375,8,18,0.444,12,19,0.632,60
3/23/12,Kansas,NC State,W 60-57,200,24,64,0.375,23,50,0.46,1,14,0.071,11,20,0.55,60
3/23/13,California,Syracuse,L 60-66,199,22,56,0.393,18,35,0.514,4,21,0.19,12,19,0.632,60
3/20/14,Dayton,Ohio State,W 60-59,200,22,49,0.449,19,36,0.528,3,13,0.231,13,17,0.765,60
3/21/14,Nebraska,Baylor,L 60-74,200,23,54,0.426,19,33,0.576,4,21,0.19,10,16,0.625,60
3/23/14,Stanford,Kansas,W 60-57,200,21,47,0.447,21,38,0.553,0,9,0,18,26,0.692,60
3/23/14,Memphis,Virginia,L 60-78,200,24,59,0.407,21,46,0.457,3,13,0.231,9,21,0.429,60
3/23/14,Stephen F. Austin,UCLA,L 60-77,200,20,57,0.351,13,30,0.433,7,27,0.259,13,16,0.813,60
3/30/14,UConn,Michigan State,W 60-54,200,17,49,0.347,12,27,0.444,5,22,0.227,21,22,0.955,60
4/7/14,UConn,Kentucky,W 60-54,200,22,53,0.415,16,34,0.471,6,19,0.316,10,10,1,60
3/19/15,UAB,Iowa State,W 60-59,200,24,69,0.348,21,51,0.412,3,18,0.167,9,11,0.818,60
3/19/15,UCLA,SMU,W 60-59,200,20,47,0.426,10,27,0.37,10,20,0.5,10,14,0.714,60
3/20/15,Albany (NY),Oklahoma,L 60-69,200,23,61,0.377,15,36,0.417,8,25,0.32,6,10,0.6,60
3/22/15,Michigan State,Virginia,W 60-54,200,17,40,0.425,11,28,0.393,6,12,0.5,20,33,0.606,60
3/26/15,Xavier,Arizona,L 60-68,200,22,51,0.431,19,34,0.559,3,17,0.176,13,16,0.813,60
3/16/11,VCU,USC,W 59-46,200,20,59,0.339,11,35,0.314,9,24,0.375,10,15,0.667,59
3/17/11,Kentucky,Princeton,W 59-57,200,24,47,0.511,19,36,0.528,5,11,0.455,6,11,0.545,59
3/20/11,Illinois,Kansas,L 59-73,200,23,60,0.383,17,39,0.436,6,21,0.286,7,9,0.778,59
3/13/12,Western Ky.,Miss Val St,W 59-58,200,19,62,0.306,17,46,0.37,2,16,0.125,19,33,0.576,59
3/14/12,Lamar,Vermont,L 59-71,200,20,60,0.333,16,47,0.34,4,13,0.308,15,21,0.714,59
3/15/12,Loyola (MD),Ohio State,L 59-78,200,19,54,0.352,15,40,0.375,4,14,0.286,17,22,0.773,59
3/15/12,Wichita State,VCU,L 59-62,200,24,62,0.387,19,46,0.413,5,16,0.313,6,10,0.6,59
3/16/12,Belmont,Georgetown,L 59-74,200,21,54,0.389,11,27,0.407,10,27,0.37,7,11,0.636,59
3/16/12,Texas,Cincinnati,L 59-65,200,20,57,0.351,13,37,0.351,7,20,0.35,12,14,0.857,59
3/17/12,Kansas State,Syracuse,L 59-75,200,21,67,0.313,17,50,0.34,4,17,0.235,13,19,0.684,59
3/17/12,Louisville,New Mexico,W 59-56,200,22,48,0.458,15,33,0.455,7,15,0.467,8,12,0.667,59
4/2/12,Kansas,Kentucky,L 59-67,200,22,62,0.355,17,51,0.333,5,11,0.455,10,15,0.667,59
3/21/13,Marquette,Davidson,W 59-58,200,20,58,0.345,16,43,0.372,4,15,0.267,15,19,0.789,59
3/24/13,Illinois,Miami (FL),L 59-63,200,23,61,0.377,16,34,0.471,7,27,0.259,6,7,0.857,59
3/31/13,Florida,Michigan,L 59-79,200,23,56,0.411,21,46,0.457,2,10,0.2,11,17,0.647,59
3/18/14,Xavier,NC State,L 59-74,200,23,55,0.418,21,41,0.512,2,14,0.143,11,16,0.688,59
3/20/14,Ohio State,Dayton,L 59-60,200,24,50,0.48,21,38,0.553,3,12,0.25,8,12,0.667,59
3/21/14,Weber State,Arizona,L 59-68,200,16,53,0.302,9,36,0.25,7,17,0.412,20,23,0.87,59
3/21/14,Coastal Caro.,Virginia,L 59-70,200,21,50,0.42,12,31,0.387,9,19,0.474,8,14,0.571,59
3/21/14,Tulsa,UCLA,L 59-76,200,21,57,0.368,14,38,0.368,7,19,0.368,10,14,0.714,59
3/28/14,Virginia,Michigan State,L 59-61,200,20,57,0.351,14,39,0.359,6,18,0.333,13,17,0.765,59
3/19/15,Iowa State,UAB,L 59-60,200,24,65,0.369,18,42,0.429,6,23,0.261,5,7,0.714,59
3/19/15,SMU,UCLA,L 59-60,200,20,55,0.364,13,39,0.333,7,16,0.438,12,20,0.6,59
3/22/15,Maryland,West Virginia,L 59-69,200,21,44,0.477,13,25,0.52,8,19,0.421,9,13,0.692,59
3/17/11,Belmont,Wisconsin,L 58-72,200,18,49,0.367,12,27,0.444,6,22,0.273,16,22,0.727,58
3/17/11,Old Dominion,Butler,L 58-60,200,16,45,0.356,11,30,0.367,5,15,0.333,21,27,0.778,58
3/19/11,Cincinnati,UConn,L 58-69,200,22,55,0.4,18,41,0.439,4,14,0.286,10,14,0.714,58
3/13/12,Miss Val St,Western Ky.,L 58-59,200,22,61,0.361,18,39,0.462,4,22,0.182,10,22,0.455,58
3/15/12,Murray State,Colorado State,W 58-41,200,20,51,0.392,15,34,0.441,5,17,0.294,13,26,0.5,58
3/16/12,Creighton,Alabama,W 58-57,200,22,50,0.44,13,29,0.448,9,21,0.429,5,13,0.385,58
3/16/12,Vermont,UNC,L 58-77,200,25,63,0.397,22,45,0.489,3,18,0.167,5,8,0.625,58
3/16/12,South Florida,Temple,W 58-44,200,17,50,0.34,9,33,0.273,8,17,0.471,16,21,0.762,58
3/18/12,Lehigh,Xavier,L 58-70,200,21,64,0.328,18,42,0.429,3,22,0.136,13,20,0.65,58
3/22/12,Marquette,Florida,L 58-68,200,20,65,0.308,14,44,0.318,6,21,0.286,12,18,0.667,58
3/21/13,Davidson,Marquette,L 58-59,200,19,46,0.413,13,29,0.448,6,17,0.353,14,22,0.636,58
3/21/13,Southern,Gonzaga,L 58-64,200,18,46,0.391,8,23,0.348,10,23,0.435,12,18,0.667,58
3/22/13,Notre Dame,Iowa State,L 58-76,199,22,51,0.431,18,34,0.529,4,17,0.235,10,13,0.769,58
3/24/13,Indiana,Temple,W 58-52,200,19,45,0.422,15,32,0.469,4,13,0.308,16,20,0.8,58
3/24/13,UNC,Kansas,L 58-70,200,22,73,0.301,16,52,0.308,6,21,0.286,8,10,0.8,58
3/28/13,La Salle,Wichita State,L 58-72,200,20,56,0.357,13,38,0.342,7,18,0.389,11,16,0.688,58
3/21/14,Stanford,New Mexico,W 58-53,200,19,49,0.388,11,34,0.324,8,15,0.533,12,17,0.706,58
3/21/15,Ohio State,Arizona,L 58-73,200,20,52,0.385,15,35,0.429,5,17,0.294,13,15,0.867,58
3/27/15,Oklahoma,Michigan State,L 58-62,200,20,55,0.364,16,38,0.421,4,17,0.235,14,16,0.875,58
3/17/11,Princeton,Kentucky,L 57-59,200,24,52,0.462,21,38,0.553,3,14,0.214,6,7,0.857,57
3/18/11,Florida State,Texas A&M,W 57-50,200,20,43,0.465,16,28,0.571,4,15,0.267,13,20,0.65,57
3/18/11,Villanova,George Mason,L 57-61,200,19,52,0.365,12,30,0.4,7,22,0.318,12,17,0.706,57
3/20/11,Notre Dame,Florida State,L 57-71,200,19,62,0.306,12,32,0.375,7,30,0.233,12,19,0.632,57
3/25/11,Richmond,Kansas,L 57-77,200,22,65,0.338,18,39,0.462,4,26,0.154,9,12,0.75,57
3/16/12,Alabama,Creighton,L 57-58,200,22,48,0.458,15,31,0.484,7,17,0.412,6,12,0.5,57
3/17/12,Vanderbilt,Wisconsin,L 57-60,200,20,46,0.435,15,27,0.556,5,19,0.263,12,16,0.75,57
3/22/12,Louisville,Michigan State,W 57-44,200,21,55,0.382,12,32,0.375,9,23,0.391,6,11,0.545,57
3/23/12,NC State,Kansas,L 57-60,200,19,67,0.284,13,46,0.283,6,21,0.286,13,17,0.765,57
3/22/13,Illinois,Colorado,W 57-49,200,16,52,0.308,8,21,0.381,8,31,0.258,17,24,0.708,57
3/22/13,Western Ky.,Kansas,L 57-64,200,21,66,0.318,18,46,0.391,3,20,0.15,12,18,0.667,57
3/22/13,Ole Miss,Wisconsin,W 57-46,200,22,57,0.386,19,42,0.452,3,15,0.2,10,16,0.625,57
3/23/13,Saint Louis,Oregon,L 57-74,200,20,53,0.377,17,32,0.531,3,21,0.143,14,22,0.636,57
3/20/14,Cincinnati,Harvard,L 57-61,200,21,57,0.368,17,45,0.378,4,12,0.333,11,16,0.688,57
3/20/14,Michigan,Wofford,W 57-40,200,22,46,0.478,15,29,0.517,7,17,0.412,6,9,0.667,57
3/23/14,Kansas,Stanford,L 57-60,200,19,58,0.328,14,42,0.333,5,16,0.313,14,18,0.778,57
3/19/15,Georgia State,Baylor,W 57-56,200,22,54,0.407,17,38,0.447,5,16,0.313,8,13,0.615,57
3/19/15,Ole Miss,Xavier,L 57-76,200,24,73,0.329,18,46,0.391,6,27,0.222,3,5,0.6,57
3/19/15,Utah,Stephen F. Austin,W 57-50,200,18,38,0.474,13,25,0.52,5,13,0.385,16,21,0.762,57
3/20/15,Louisville,UC-Irvine,W 57-55,200,23,55,0.418,18,40,0.45,5,15,0.333,6,6,1,57
3/27/15,Utah,Duke,L 57-63,200,21,60,0.35,17,44,0.386,4,16,0.25,11,15,0.733,57
3/18/11,Akron,Notre Dame,L 56-69,200,23,64,0.359,16,43,0.372,7,21,0.333,3,6,0.5,56
3/18/11,Georgetown,VCU,L 56-74,200,20,52,0.385,15,26,0.577,5,26,0.192,11,13,0.846,56
4/2/11,UConn,Kentucky,W 56-55,200,23,49,0.469,22,37,0.595,1,12,0.083,9,11,0.818,56
3/17/12,New Mexico,Louisville,L 56-59,200,23,58,0.397,18,35,0.514,5,23,0.217,5,8,0.625,56
3/18/12,Florida State,Cincinnati,L 56-62,200,19,50,0.38,13,33,0.394,6,17,0.353,12,15,0.8,56
3/18/12,South Florida,Ohio,L 56-62,200,20,46,0.435,18,31,0.581,2,15,0.133,14,19,0.737,56
3/21/13,Bucknell,Butler,L 56-68,200,23,62,0.371,18,46,0.391,5,16,0.313,5,8,0.625,56
3/21/13,S Dakota St.,Michigan,L 56-71,200,23,52,0.442,19,33,0.576,4,19,0.211,6,8,0.75,56
3/23/13,Colorado State,Louisville,L 56-82,200,19,40,0.475,14,28,0.5,5,12,0.417,13,21,0.619,56
4/6/13,Syracuse,Michigan,L 56-61,201,23,55,0.418,20,41,0.488,3,14,0.214,7,11,0.636,56
3/21/14,Kentucky,Kansas State,W 56-49,200,19,50,0.38,15,35,0.429,4,15,0.267,14,21,0.667,56
3/18/15,Dayton,Boise State,W 56-55,200,20,42,0.476,13,21,0.619,7,21,0.333,9,14,0.643,56
3/19/15,Arkansas,Wofford,W 56-53,200,22,48,0.458,19,40,0.475,3,8,0.375,9,16,0.563,56
3/19/15,Baylor,Georgia State,L 56-57,200,19,43,0.442,12,24,0.5,7,19,0.368,11,13,0.846,56
3/19/15,Butler,Texas,W 56-48,200,16,48,0.333,12,35,0.343,4,13,0.308,20,28,0.714,56
3/19/15,Hampton,Kentucky,L 56-79,200,17,59,0.288,13,43,0.302,4,16,0.25,18,23,0.783,56
3/20/15,Robert Morris,Duke,L 56-85,200,24,66,0.364,18,47,0.383,6,19,0.316,2,4,0.5,56
3/20/15,New Mexico St.,Kansas,L 56-75,200,20,56,0.357,15,41,0.366,5,15,0.333,11,16,0.688,56
3/18/11,Xavier,Marquette,L 55-66,200,21,51,0.412,19,38,0.5,2,13,0.154,11,15,0.733,55
4/2/11,Kentucky,UConn,L 55-56,200,21,62,0.339,12,35,0.343,9,27,0.333,4,12,0.333,55
3/20/13,LIU,James Madison,L 55-68,200,21,59,0.356,18,43,0.419,3,16,0.188,10,14,0.714,55
3/21/13,Oklahoma State,Oregon,L 55-68,200,21,52,0.404,16,35,0.457,5,17,0.294,8,15,0.533,55
3/21/13,Pitt,Wichita State,L 55-73,200,19,54,0.352,18,37,0.486,1,17,0.059,16,20,0.8,55
3/22/13,Oklahoma,San Diego State,L 55-70,200,23,58,0.397,18,37,0.486,5,21,0.238,4,8,0.5,55
3/30/13,Syracuse,Marquette,W 55-39,200,19,50,0.38,14,33,0.424,5,17,0.294,12,19,0.632,55
3/20/14,Albany (NY),Florida,L 55-67,200,20,51,0.392,16,38,0.421,4,13,0.308,11,14,0.786,55
3/22/14,Dayton,Syracuse,W 55-53,200,19,46,0.413,12,30,0.4,7,16,0.438,10,18,0.556,55
3/23/14,Creighton,Baylor,L 55-85,200,22,55,0.4,17,31,0.548,5,24,0.208,6,9,0.667,55
3/18/15,Boise State,Dayton,L 55-56,200,22,55,0.4,16,35,0.457,6,20,0.3,5,10,0.5,55
3/20/15,UC-Irvine,Louisville,L 55-57,200,24,52,0.462,19,38,0.5,5,14,0.357,2,2,1,55
3/24/11,Wisconsin,Butler,L 54-61,200,17,56,0.304,10,27,0.37,7,29,0.241,13,19,0.684,54
3/14/12,California,South Florida,L 54-65,200,21,58,0.362,18,44,0.409,3,14,0.214,9,14,0.643,54
3/15/12,West Virginia,Gonzaga,L 54-77,200,16,49,0.327,13,32,0.406,3,17,0.176,19,28,0.679,54
3/16/12,Memphis,Saint Louis,L 54-61,200,21,54,0.389,19,39,0.487,2,15,0.133,10,17,0.588,54
3/19/13,Middle Tenn.,Saint Mary's,L 54-67,200,22,52,0.423,18,40,0.45,4,12,0.333,6,7,0.857,54
3/21/13,Memphis,Saint Mary's,W 54-52,201,20,49,0.408,15,34,0.441,5,15,0.333,9,18,0.5,54
3/21/13,Valparaiso,Michigan State,L 54-65,199,19,54,0.352,12,29,0.414,7,25,0.28,9,14,0.643,54
3/30/14,Michigan State,UConn,L 54-60,200,18,46,0.391,7,17,0.412,11,29,0.379,7,8,0.875,54
4/7/14,Kentucky,UConn,L 54-60,200,18,46,0.391,13,30,0.433,5,16,0.313,13,24,0.542,54
3/20/15,Wyoming,Northern Iowa,L 54-71,200,21,46,0.457,12,24,0.5,9,22,0.409,3,9,0.333,54
3/22/15,Virginia,Michigan State,L 54-60,200,17,57,0.298,15,40,0.375,2,17,0.118,18,26,0.692,54
3/18/11,Boston U.,Kansas,L 53-72,200,18,51,0.353,9,26,0.346,9,25,0.36,8,12,0.667,53
4/4/11,UConn,Butler,W 53-41,200,19,55,0.345,18,44,0.409,1,11,0.091,14,16,0.875,53
3/17/12,Murray State,Marquette,L 53-62,200,20,64,0.313,16,43,0.372,4,21,0.19,9,10,0.9,53
3/23/13,VCU,Michigan,L 53-78,200,23,58,0.397,20,42,0.476,3,16,0.188,4,6,0.667,53
3/20/14,Milwaukee,Villanova,L 53-73,200,18,63,0.286,12,39,0.308,6,24,0.25,11,15,0.733,53
3/20/14,Western Mich.,Syracuse,L 53-77,200,17,49,0.347,13,31,0.419,4,18,0.222,15,20,0.75,53
3/21/14,New Mexico,Stanford,L 53-58,201,19,52,0.365,15,31,0.484,4,21,0.19,11,19,0.579,53
3/22/14,Syracuse,Dayton,L 53-55,200,21,54,0.389,21,44,0.477,0,10,0,11,14,0.786,53
4/5/14,Florida,UConn,L 53-63,200,19,49,0.388,18,39,0.462,1,10,0.1,14,20,0.7,53
3/19/15,Wofford,Arkansas,L 53-56,200,18,57,0.316,11,33,0.333,7,24,0.292,10,16,0.625,53
3/20/15,Providence,Dayton,L 53-66,200,20,59,0.339,10,33,0.303,10,26,0.385,3,7,0.429,53
3/22/15,Northern Iowa,Louisville,L 53-66,200,18,46,0.391,12,27,0.444,6,19,0.316,11,13,0.846,53
3/15/11,UAB,Clemson,L 52-70,200,18,48,0.375,6,24,0.25,12,24,0.5,4,7,0.571,52
3/17/11,Bucknell,UConn,L 52-81,200,16,51,0.314,9,30,0.3,7,21,0.333,13,15,0.867,52
3/21/13,Saint Mary's,Memphis,L 52-54,201,19,58,0.328,16,43,0.372,3,15,0.2,11,14,0.786,52
3/24/13,Temple,Indiana,L 52-58,200,21,62,0.339,18,38,0.474,3,24,0.125,7,8,0.875,52
3/27/14,Baylor,Wisconsin,L 52-69,200,18,57,0.316,16,42,0.381,2,15,0.133,14,18,0.778,52
3/29/14,Dayton,Florida,L 52-62,200,19,48,0.396,11,30,0.367,8,18,0.444,6,8,0.75,52
3/19/15,Lafayette,Villanova,L 52-93,200,21,55,0.382,17,37,0.459,4,18,0.222,6,7,0.857,52
3/20/15,Davidson,Iowa,L 52-83,200,21,63,0.333,15,35,0.429,6,28,0.214,4,10,0.4,52
3/29/15,Gonzaga,Duke,L 52-66,200,22,50,0.44,20,40,0.5,2,10,0.2,6,9,0.667,52
3/17/11,UCSB,Florida,L 51-79,200,17,47,0.362,12,28,0.429,5,19,0.263,12,18,0.667,51
3/17/11,UNC Asheville,Pitt,L 51-74,200,17,55,0.309,14,36,0.389,3,19,0.158,14,19,0.737,51
3/23/13,Harvard,Arizona,L 51-74,200,16,58,0.276,11,40,0.275,5,18,0.278,14,19,0.737,51
3/22/14,Saint Louis,Louisville,L 51-66,200,21,53,0.396,21,38,0.553,0,15,0,9,16,0.563,51
3/21/15,Cincinnati,Kentucky,L 51-64,199,20,63,0.317,18,49,0.367,2,14,0.143,9,14,0.643,51
3/17/11,Northern Colo.,San Diego State,L 50-68,200,19,56,0.339,11,34,0.324,8,22,0.364,4,8,0.5,50
3/18/11,Texas A&M,Florida State,L 50-57,200,16,51,0.314,7,26,0.269,9,25,0.36,9,19,0.474,50
3/16/12,Detroit,Kansas,L 50-65,200,20,63,0.317,17,46,0.37,3,17,0.176,7,14,0.5,50
3/18/12,Norfolk State,Florida,L 50-84,200,18,66,0.273,14,42,0.333,4,24,0.167,10,13,0.769,50
3/24/13,Creighton,Duke,L 50-66,200,16,53,0.302,14,34,0.412,2,19,0.105,16,18,0.889,50
3/28/13,Indiana,Syracuse,L 50-61,203,16,47,0.34,13,32,0.406,3,15,0.2,15,24,0.625,50
3/29/13,Fla. Gulf Coast,Florida,L 50-62,200,20,44,0.455,16,33,0.485,4,11,0.364,6,11,0.545,50
3/19/15,Stephen F. Austin,Utah,L 50-57,199,17,51,0.333,12,25,0.48,5,26,0.192,11,13,0.846,50
3/15/12,Montana,Wisconsin,L 49-73,200,18,47,0.383,15,38,0.395,3,9,0.333,10,15,0.667,49
3/22/13,Colorado,Illinois,L 49-57,200,17,51,0.333,12,32,0.375,5,19,0.263,10,13,0.769,49
3/22/13,Pacific,Miami (FL),L 49-78,200,18,54,0.333,9,28,0.321,9,26,0.346,4,11,0.364,49
3/21/14,Kansas State,Kentucky,L 49-56,200,19,53,0.358,14,32,0.438,5,21,0.238,6,12,0.5,49
3/22/15,San Diego State,Duke,L 49-68,200,19,58,0.328,17,45,0.378,2,13,0.154,9,11,0.818,49
3/19/11,Morehead State,Richmond,L 48-65,200,18,48,0.375,16,34,0.471,2,14,0.143,10,15,0.667,48
3/21/13,N.C. A&T,Louisville,L 48-79,200,17,41,0.415,11,25,0.44,6,16,0.375,8,10,0.8,48
3/23/13,Memphis,Michigan State,L 48-70,200,19,64,0.297,14,41,0.341,5,23,0.217,5,10,0.5,48
3/20/14,Colorado,Pitt,L 48-77,200,15,42,0.357,11,26,0.423,4,16,0.25,14,18,0.778,48
3/19/15,Texas,Butler,L 48-56,200,17,50,0.34,11,31,0.355,6,19,0.316,8,12,0.667,48
3/22/13,NW St.,Florida,L 47-79,200,18,50,0.36,15,34,0.441,3,16,0.188,8,11,0.727,47
3/16/11,USC,VCU,L 46-59,200,15,38,0.395,14,29,0.483,1,9,0.111,15,25,0.6,46
3/18/11,UTSA,Ohio State,L 46-75,200,18,53,0.34,14,36,0.389,4,17,0.235,6,7,0.857,46
3/22/13,Wisconsin,Ole Miss,L 46-57,200,15,59,0.254,8,29,0.276,7,30,0.233,9,13,0.692,46
3/18/11,Hampton,Duke,L 45-87,200,19,55,0.345,15,41,0.366,4,14,0.286,3,7,0.429,45
3/18/11,Tennessee,Michigan,L 45-75,200,15,43,0.349,12,25,0.48,3,18,0.167,12,16,0.75,45
3/16/12,Virginia,Florida,L 45-71,200,18,47,0.383,15,29,0.517,3,18,0.167,6,10,0.6,45
3/22/14,Pitt,Florida,L 45-61,200,19,51,0.373,15,34,0.441,4,17,0.235,3,6,0.5,45
3/16/12,Temple,South Florida,L 44-58,200,15,42,0.357,13,30,0.433,2,12,0.167,12,16,0.75,44
3/22/12,Michigan State,Louisville,L 44-57,200,14,49,0.286,9,28,0.321,5,21,0.238,11,12,0.917,44
3/21/13,New Mexico St.,Saint Louis,L 44-64,200,17,61,0.279,15,45,0.333,2,16,0.125,8,13,0.615,44
3/22/14,North Dakota St.,San Diego State,L 44-63,200,15,47,0.319,13,36,0.361,2,11,0.182,12,17,0.706,44
3/18/11,St. Peter's,Purdue,L 43-65,200,17,58,0.293,12,37,0.324,5,21,0.238,4,6,0.667,43
3/21/13,Akron,VCU,L 42-88,200,15,43,0.349,14,30,0.467,1,13,0.077,11,19,0.579,42
4/4/11,Butler,UConn,L 41-53,200,12,64,0.188,3,31,0.097,9,33,0.273,8,14,0.571,41
3/15/12,Colorado State,Murray State,L 41-58,200,16,48,0.333,13,34,0.382,3,14,0.214,6,9,0.667,41
3/20/14,Wofford,Michigan,L 40-57,200,18,53,0.34,17,34,0.5,1,19,0.053,3,4,0.75,40
3/30/13,Marquette,Syracuse,L 39-55,200,12,53,0.226,9,28,0.321,3,25,0.12,12,16,0.75,39
3/26/15,West Virginia,Kentucky,L 39-78,200,13,54,0.241,11,39,0.282,2,15,0.133,11,19,0.579,39
3/21/14,Cal Poly,Wichita State,L 37-64,200,12,58,0.207,7,30,0.233,5,28,0.179,8,18,0.444,37
3/20/14,American,Wisconsin,L 35-75,200,11,37,0.297,7,22,0.318,4,15,0.267,9,15,0.6,35
3/21/13,Montana,Syracuse,L 34-81,200,11,54,0.204,7,23,0.304,4,31,0.129,8,12,0.667,34